date,week,colors,new_pos,tot_case,tot_hosp,perc_pos,RT_sym,RT_hosp,var_hosp,new_dies,tot_dies,new_tests,tot_tests,vax,CI_low_sym,CI_up_sym,CI_low_hosp,CI_up_hosp,incid_100k_7ns
2020-02-24,9_2020,0,221,229,127,5.11,2.91,NA,127,7,7,4324,4324,NA,2.8,3.03,NA,NA,3
2020-02-25,9_2020,0,93,322,150,2.16,2.97,NA,23,3,10,4299,8623,NA,2.86,3.07,NA,NA,3
2020-02-26,9_2020,0,78,400,164,8.09,2.83,NA,14,2,12,964,9587,NA,2.74,2.92,NA,NA,3
2020-02-27,9_2020,0,250,650,304,10.3,2.57,NA,140,5,17,2427,12014,NA,2.49,2.65,NA,NA,3
2020-02-28,9_2020,0,238,888,409,6.47,2.57,NA,105,4,21,3681,15695,NA,2.5,2.65,NA,NA,3
2020-02-29,9_2020,0,240,1128,506,8.09,2.42,NA,97,8,29,2966,18661,NA,2.35,2.48,NA,NA,3
2020-03-01,9_2020,0,566,1694,779,22.95,2.7,NA,273,5,34,2466,21127,NA,2.64,2.77,NA,NA,3
2020-03-02,10_2020,0,342,2036,908,15.42,2.61,5.07,129,18,52,2218,23345,NA,2.55,2.66,4.9,5.25,10
2020-03-03,10_2020,0,466,2502,1263,18.56,2.49,4.63,355,27,79,2511,25856,NA,2.44,2.54,4.49,4.77,10
2020-03-04,10_2020,0,587,3089,1641,14.75,2.32,4.36,378,28,107,3981,29837,NA,2.28,2.37,4.24,4.47,10
2020-03-05,10_2020,0,769,3858,2141,30.46,2.26,4.11,500,41,148,2525,32362,NA,2.22,2.3,4.02,4.21,10
2020-03-06,10_2020,0,778,4636,2856,19.46,2.17,3.97,715,49,197,3997,36359,NA,2.14,2.21,3.89,4.05,10
2020-03-07,10_2020,0,1247,5883,3218,21.87,2.12,3.73,362,36,233,5703,42062,NA,2.09,2.16,3.66,3.79,10
2020-03-08,10_2020,0,1492,7375,4207,18.95,1.98,3.55,989,133,366,7875,49937,NA,1.95,2.01,3.5,3.61,10
2020-03-09,11_2020,84,1797,9172,5049,46.21,1.96,3.41,842,97,463,3889,53826,NA,1.93,1.99,3.36,3.45,29
2020-03-10,11_2020,84,977,10149,5915,14.09,2.05,3.23,866,168,631,6935,60761,NA,2.02,2.07,3.19,3.27,29
2020-03-11,11_2020,84,2313,12462,6866,18.66,1.96,3.06,951,196,827,12393,73154,NA,1.94,1.99,3.03,3.1,29
2020-03-12,11_2020,84,2651,15113,7803,20.62,1.87,2.89,937,189,1016,12857,86011,NA,1.85,1.89,2.86,2.92,29
2020-03-13,11_2020,84,2547,17660,8754,22.19,1.8,2.71,951,250,1266,11477,97488,NA,1.78,1.82,2.68,2.73,29
2020-03-14,11_2020,84,3497,21157,9890,29.93,1.69,2.57,1136,175,1441,11682,109170,NA,1.67,1.71,2.55,2.59,29
2020-03-15,11_2020,84,3590,24747,11335,22.82,1.63,2.44,1445,368,1809,15729,124899,NA,1.61,1.64,2.42,2.47,29
2020-03-16,12_2020,84,3233,27980,12876,24.75,1.53,2.34,1541,349,2158,13063,137962,NA,1.51,1.54,2.32,2.36,58
2020-03-17,12_2020,84,3526,31506,14954,32.97,1.35,2.27,2078,345,2503,10695,148657,NA,1.33,1.36,2.25,2.29,58
2020-03-18,12_2020,84,4207,35713,16620,24.92,1.29,2.2,1666,475,2978,16884,165541,NA,1.27,1.3,2.19,2.22,58
2020-03-19,12_2020,84,5322,41035,18255,30.88,1.2,2.14,1635,427,3405,17236,182777,NA,1.19,1.22,2.13,2.15,58
2020-03-20,12_2020,84,5986,47021,18675,24.83,1.18,2.05,420,627,4032,24109,206886,NA,1.17,1.19,2.04,2.07,58
2020-03-21,12_2020,84,6557,53578,20565,24.9,1.12,1.98,1890,793,4825,26336,233222,NA,1.1,1.13,1.97,1.99,58
2020-03-22,12_2020,84,5560,59138,22855,22.08,1.02,1.92,2290,651,5476,25180,258402,NA,1.01,1.04,1.91,1.94,58
2020-03-23,13_2020,84,4789,63927,23896,28.06,0.98,1.86,1041,601,6077,17066,275468,NA,0.97,0.99,1.85,1.87,65
2020-03-24,13_2020,84,5249,69176,25333,24.42,0.94,1.79,1437,743,6820,21496,296964,NA,0.93,0.95,1.78,1.8,65
2020-03-25,13_2020,84,5210,74386,26601,18.96,0.91,1.72,1268,683,7503,27481,324445,NA,0.89,0.92,1.71,1.73,65
2020-03-26,13_2020,84,6153,80539,28365,16.8,0.88,1.66,1764,662,8165,36615,361060,NA,0.87,0.89,1.65,1.67,65
2020-03-27,13_2020,84,5959,86498,29761,18.05,0.8,1.61,1396,969,9134,33019,394079,NA,0.79,0.81,1.61,1.62,65
2020-03-28,13_2020,84,5974,92472,30532,16.85,0.79,1.57,771,889,10023,35447,429526,NA,0.78,0.81,1.56,1.57,65
2020-03-29,13_2020,84,5217,97689,31292,21.29,0.77,1.51,760,756,10779,24504,454030,NA,0.76,0.78,1.5,1.52,65
2020-03-30,14_2020,84,4050,101739,31776,17.36,0.76,1.46,484,812,11591,23329,477359,NA,0.75,0.77,1.45,1.47,53
2020-03-31,14_2020,84,4053,105792,32215,13.69,0.75,1.41,439,837,12428,29609,506968,NA,0.74,0.76,1.41,1.42,53
2020-04-01,14_2020,84,4782,110574,32438,13.88,0.79,1.37,223,727,13155,34455,541423,NA,0.78,0.8,1.36,1.37,53
2020-04-02,14_2020,84,4668,115242,32593,11.73,0.79,1.32,155,760,13915,39809,581232,NA,0.78,0.8,1.31,1.32,53
2020-04-03,14_2020,84,4585,119827,32809,11.87,0.78,1.27,216,766,14681,38617,619849,NA,0.77,0.8,1.27,1.28,53
2020-04-04,14_2020,84,4805,124632,33004,12.86,0.78,1.23,195,681,15362,37375,657224,NA,0.76,0.79,1.23,1.24,53
2020-04-05,14_2020,84,4316,128948,32926,12.61,0.79,1.19,-78,525,15887,34237,691461,NA,0.77,0.8,1.19,1.2,53
2020-04-06,15_2020,84,3599,132547,32874,11.89,0.76,1.16,-52,636,16523,30271,721732,NA,0.75,0.77,1.16,1.17,46
2020-04-07,15_2020,84,3039,135586,32510,9.01,0.77,1.13,-364,604,17127,33713,755445,NA,0.76,0.78,1.13,1.14,46
2020-04-08,15_2020,84,3836,139422,32178,7.42,0.71,1.1,-332,542,17669,51680,807125,NA,0.7,0.73,1.1,1.11,46
2020-04-09,15_2020,84,4204,143626,32004,9.09,0.71,1.08,-174,610,18279,46244,853369,NA,0.7,0.73,1.08,1.08,46
2020-04-10,15_2020,84,3951,147577,31739,7.39,0.74,1.06,-265,570,18849,53495,906864,NA,0.73,0.75,1.05,1.06,46
2020-04-11,15_2020,84,4694,152271,31525,8.29,0.74,1.04,-214,619,19468,56609,963473,NA,0.72,0.75,1.03,1.04,46
2020-04-12,15_2020,84,4092,156363,31190,8.76,0.75,1.02,-335,431,19899,46720,1010193,NA,0.74,0.76,1.02,1.03,46
2020-04-13,16_2020,84,3153,159516,31283,8.59,0.74,1.01,93,566,20465,36717,1046910,NA,0.73,0.76,1,1.01,38
2020-04-14,16_2020,84,2972,162488,31197,11.1,0.76,1,-86,602,21067,26779,1073689,NA,0.74,0.77,0.99,1,38
2020-04-15,16_2020,84,2667,165155,30722,6.1,0.78,0.99,-475,578,21645,43715,1117404,NA,0.77,0.8,0.99,0.99,38
2020-04-16,16_2020,84,3786,168941,29829,6.21,0.8,0.98,-893,525,22170,60999,1178403,NA,0.78,0.81,0.98,0.98,38
2020-04-17,16_2020,84,3493,172434,28598,5.32,0.76,0.97,-1231,575,22745,65705,1244108,NA,0.75,0.78,0.96,0.97,38
2020-04-18,16_2020,84,3491,175925,27740,5.66,0.78,0.95,-858,482,23227,61725,1305833,NA,0.76,0.79,0.95,0.96,38
2020-04-19,16_2020,84,3047,178972,27668,6.01,0.76,0.94,-72,433,23660,50708,1356541,NA,0.75,0.78,0.94,0.95,38
2020-04-20,17_2020,84,2256,181228,27479,5.44,0.82,0.93,-189,454,24114,41483,1398024,NA,0.8,0.84,0.93,0.93,31
2020-04-21,17_2020,84,2729,183957,26605,5.24,0.8,0.92,-874,534,24648,52126,1450150,NA,0.78,0.81,0.91,0.92,31
2020-04-22,17_2020,84,3370,187327,26189,5.34,0.76,0.91,-416,437,25085,63101,1513251,NA,0.75,0.78,0.9,0.91,31
2020-04-23,17_2020,84,2646,189973,25138,3.97,0.75,0.89,-1051,464,25549,66658,1579909,NA,0.73,0.76,0.89,0.9,31
2020-04-24,17_2020,84,3021,192994,24241,4.84,0.73,0.89,-897,420,25969,62447,1642356,NA,0.71,0.74,0.88,0.89,31
2020-04-25,17_2020,84,2357,195351,23635,3.6,0.71,0.88,-606,415,26384,65387,1707743,NA,0.7,0.73,0.88,0.88,31
2020-04-26,17_2020,84,2324,197675,23381,4.66,0.71,0.87,-254,260,26644,49916,1757659,NA,0.7,0.73,0.87,0.88,31
2020-04-27,18_2020,84,1739,199414,22309,5.43,0.67,0.86,-1072,333,26977,32003,1789662,NA,0.65,0.68,0.86,0.87,22
2020-04-28,18_2020,84,2091,201505,21586,3.65,0.66,0.85,-723,382,27359,57272,1846934,NA,0.64,0.68,0.85,0.86,22
2020-04-29,18_2020,84,2086,203591,21005,3.27,0.64,0.85,-581,323,27682,63827,1910761,NA,0.63,0.66,0.84,0.85,22
2020-04-30,18_2020,84,1872,205463,19843,2.73,0.63,0.84,-1162,285,27967,68456,1979217,NA,0.61,0.65,0.83,0.84,22
2020-05-01,18_2020,84,1965,207428,19147,2.65,0.63,0.83,-696,269,28236,74208,2053425,NA,0.61,0.65,0.82,0.83,22
2020-05-02,18_2020,84,1900,209328,18896,3.43,0.62,0.82,-251,474,28710,55412,2108837,NA,0.6,0.64,0.82,0.83,22
2020-05-03,18_2020,84,1389,210717,18743,3.09,0.62,0.82,-153,174,28884,44935,2153772,NA,0.6,0.64,0.81,0.82,22
2020-05-04,19_2020,84,1221,211938,18302,3.24,0.58,0.82,-441,195,29079,37631,2191403,NA,0.56,0.6,0.81,0.82,14
2020-05-05,19_2020,21,1075,213013,17697,1.95,0.59,0.81,-605,236,29315,55263,2246666,NA,0.57,0.61,0.81,0.82,14
2020-05-06,19_2020,21,1444,214457,17102,2.25,0.59,0.81,-595,369,29684,64263,2310929,NA,0.57,0.61,0.81,0.82,14
2020-05-07,19_2020,21,1401,215858,16485,1.99,0.59,0.82,-617,274,29958,70359,2381288,NA,0.57,0.61,0.81,0.82,14
2020-05-08,19_2020,21,1327,217185,15804,2.08,0.6,0.82,-681,243,30201,63775,2445063,NA,0.58,0.62,0.81,0.82,14
2020-05-09,19_2020,21,1083,218268,14868,1.57,0.6,0.81,-936,194,30395,69171,2514234,NA,0.58,0.62,0.81,0.82,14
2020-05-10,19_2020,21,802,219070,14645,1.55,0.63,0.81,-223,165,30560,51678,2565912,NA,0.6,0.65,0.8,0.81,14
2020-05-11,20_2020,21,744,219814,14538,1.83,0.64,0.8,-107,179,30739,40740,2606652,NA,0.61,0.66,0.8,0.81,11
2020-05-12,20_2020,21,1402,221216,13817,2.09,0.64,0.8,-721,172,30911,67003,2673655,NA,0.61,0.66,0.8,0.8,11
2020-05-13,20_2020,21,888,222104,13065,1.43,0.65,0.79,-752,195,31106,61973,2735628,NA,0.62,0.68,0.79,0.8,11
2020-05-14,20_2020,21,992,223096,12308,1.38,0.65,0.79,-757,262,31368,71876,2807504,NA,0.63,0.68,0.78,0.79,11
2020-05-15,20_2020,21,789,223885,11600,1.16,0.65,0.78,-708,242,31610,68176,2875680,NA,0.62,0.68,0.77,0.78,11
2020-05-16,20_2020,21,875,224760,11175,1.26,0.68,0.77,-425,153,31763,69179,2944859,NA,0.65,0.71,0.77,0.78,11
2020-05-17,20_2020,21,675,225435,11073,1.12,0.68,0.77,-102,145,31908,60101,3004960,NA,0.64,0.71,0.76,0.77,11
2020-05-18,21_2020,21,451,225886,10956,1.24,0.68,0.76,-117,99,32007,36406,3041366,NA,0.65,0.72,0.76,0.77,7
2020-05-19,21_2020,21,813,226699,10707,1.29,0.67,0.76,-249,162,32169,63158,3104524,NA,0.64,0.7,0.76,0.77,7
2020-05-20,21_2020,21,665,227364,10300,0.99,0.68,0.76,-407,161,32330,67195,3171719,NA,0.65,0.72,0.76,0.77,7
2020-05-21,21_2020,21,642,228006,9909,0.9,0.68,0.77,-391,156,32486,71679,3243398,NA,0.65,0.72,0.76,0.77,7
2020-05-22,21_2020,21,652,228658,9552,0.86,0.66,0.78,-357,130,32616,75380,3318778,NA,0.62,0.69,0.77,0.78,7
2020-05-23,21_2020,21,669,229327,9267,0.92,0.66,0.78,-285,119,32735,72410,3391188,NA,0.62,0.69,0.78,0.79,7
2020-05-24,21_2020,21,531,229858,9166,0.95,0.66,0.79,-101,50,32785,55824,3447012,NA,0.62,0.7,0.78,0.8,7
2020-05-25,22_2020,21,300,230158,8726,0.85,0.66,0.79,-440,92,32877,35241,3482253,NA,0.62,0.7,0.78,0.8,5
2020-05-26,22_2020,21,397,230555,8438,0.69,0.66,0.79,-288,78,32955,57674,3539927,NA,0.62,0.7,0.78,0.8,5
2020-05-27,22_2020,21,584,231139,8234,0.87,0.66,0.79,-204,117,33072,67324,3607251,NA,0.62,0.7,0.79,0.8,5
2020-05-28,22_2020,21,593,231732,7868,0.78,0.67,0.79,-366,70,33142,75893,3683144,NA,0.63,0.71,0.79,0.8,5
2020-05-29,22_2020,21,516,232248,7569,0.72,0.68,0.79,-299,87,33229,72135,3755279,NA,0.64,0.72,0.79,0.8,5
2020-05-30,22_2020,21,416,232664,7130,0.6,0.7,0.79,-439,111,33340,69342,3824621,NA,0.65,0.74,0.78,0.79,5
2020-05-31,22_2020,21,355,233019,6822,0.66,0.71,0.78,-308,75,33415,54118,3878739,NA,0.67,0.76,0.77,0.79,5
2020-06-01,23_2020,21,178,233197,6523,0.57,0.7,0.78,-299,60,33475,31394,3910133,NA,0.66,0.75,0.77,0.78,3
2020-06-02,23_2020,21,318,233515,6324,0.61,0.66,0.77,-199,55,33530,52159,3962292,NA,0.61,0.71,0.76,0.78,3
2020-06-03,23_2020,21,321,233836,6095,0.86,0.65,0.76,-229,71,33601,37299,3999591,NA,0.6,0.7,0.76,0.77,3
2020-06-04,23_2020,21,177,234013,5841,0.35,0.66,0.76,-254,88,33689,49953,4049544,NA,0.61,0.71,0.75,0.77,3
2020-06-05,23_2020,21,518,234531,5617,0.8,0.69,0.75,-224,85,33774,65028,4114572,NA,0.64,0.74,0.75,0.76,3
2020-06-06,23_2020,21,270,234801,5295,0.37,0.71,0.75,-322,72,33846,72485,4187057,NA,0.66,0.76,0.74,0.76,3
2020-06-07,23_2020,21,197,234998,5151,0.4,0.75,0.75,-144,53,33899,49478,4236535,NA,0.69,0.8,0.74,0.76,3
2020-06-08,24_2020,21,280,235278,5012,1.03,0.76,0.75,-139,65,33964,27112,4263647,NA,0.7,0.82,0.74,0.76,3
2020-06-09,24_2020,21,283,235561,4844,0.51,0.84,0.75,-168,79,34043,55003,4318650,NA,0.78,0.91,0.74,0.76,3
2020-06-10,24_2020,21,202,235763,4569,0.32,0.85,0.75,-275,71,34114,62699,4381349,NA,0.79,0.92,0.74,0.76,3
2020-06-11,24_2020,21,379,236142,4367,0.61,0.87,0.75,-202,53,34167,62472,4443821,NA,0.81,0.94,0.74,0.76,3
2020-06-12,24_2020,21,163,236305,4120,0.23,0.88,0.75,-247,56,34223,70620,4514441,NA,0.81,0.95,0.74,0.75,3
2020-06-13,24_2020,21,346,236651,3967,0.7,0.88,0.74,-153,78,34301,49750,4564191,NA,0.82,0.95,0.74,0.75,3
2020-06-14,24_2020,21,338,236989,3803,0.6,0.91,0.74,-164,44,34345,56527,4620718,NA,0.84,0.98,0.73,0.75,3
2020-06-15,25_2020,21,303,237290,3696,1.08,0.91,0.74,-107,26,34371,28107,4648825,NA,0.84,0.98,0.73,0.75,3
2020-06-16,25_2020,21,210,237500,3478,0.45,0.91,0.74,-218,34,34405,46882,4695707,NA,0.84,0.98,0.73,0.74,3
2020-06-17,25_2020,21,329,237828,3276,0.42,0.89,0.73,-202,43,34448,77701,4773408,NA,0.82,0.96,0.72,0.74,3
2020-06-18,25_2020,21,333,238159,3035,0.57,0.89,0.72,-241,66,34514,58154,4831562,NA,0.82,0.96,0.72,0.73,3
2020-06-19,25_2020,21,251,238011,2793,0.44,0.86,0.72,-242,47,34561,57541,4889103,NA,0.79,0.93,0.71,0.73,3
2020-06-20,25_2020,21,262,238275,2626,0.48,0.87,0.71,-167,49,34610,54722,4943825,NA,0.8,0.94,0.7,0.72,3
2020-06-21,25_2020,21,224,238499,2462,0.55,0.87,0.7,-164,24,34634,40545,4984370,NA,0.8,0.94,0.69,0.71,3
2020-06-22,26_2020,21,218,238720,2165,0.75,0.85,0.68,-297,23,34657,28972,5013342,NA,0.78,0.92,0.67,0.69,2
2020-06-23,26_2020,21,122,238833,1968,0.3,0.83,0.66,-197,18,34675,40485,5053827,NA,0.76,0.91,0.65,0.67,2
2020-06-24,26_2020,21,190,239410,1717,0.36,0.88,0.63,-251,-31,34644,53266,5107093,NA,0.8,0.95,0.62,0.64,2
2020-06-25,26_2020,21,296,239706,1618,0.53,0.89,0.61,-99,34,34678,56061,5163154,NA,0.81,0.97,0.6,0.62,2
2020-06-26,26_2020,21,259,239961,1461,0.49,0.93,0.59,-157,30,34708,52768,5215922,NA,0.85,1.01,0.58,0.6,2
2020-06-27,26_2020,21,175,240136,1357,0.29,0.94,0.57,-104,8,34716,61351,5277273,NA,0.86,1.02,0.56,0.58,2
2020-06-28,26_2020,21,174,240310,1258,0.47,0.94,0.56,-99,22,34738,37346,5314619,NA,0.86,1.02,0.55,0.57,2
2020-06-29,27_2020,21,126,240436,1216,0.46,0.97,0.55,-42,6,34744,27218,5341837,NA,0.89,1.05,0.54,0.56,2
2020-06-30,27_2020,21,142,240578,1183,0.29,0.97,0.54,-33,23,34767,48273,5390110,NA,0.89,1.05,0.53,0.55,2
2020-07-01,27_2020,21,187,240760,1112,0.34,1,0.55,-71,21,34788,55366,5445476,NA,0.92,1.09,0.54,0.56,2
2020-07-02,27_2020,21,201,240961,1045,0.38,1.01,0.56,-67,30,34818,53243,5498719,NA,0.92,1.09,0.54,0.57,2
2020-07-03,27_2020,21,223,241184,1035,0.45,0.97,0.57,-10,15,34833,50096,5548815,NA,0.89,1.05,0.56,0.58,2
2020-07-04,27_2020,21,235,241419,1011,0.45,0.99,0.59,-24,21,34854,52011,5600826,NA,0.91,1.08,0.57,0.6,2
2020-07-05,27_2020,21,192,241611,1019,0.51,1,0.61,8,7,34861,37462,5638288,NA,0.92,1.09,0.6,0.62,2
2020-07-06,28_2020,21,208,241819,1018,0.94,1.01,0.64,-1,8,34869,22166,5660454,NA,0.93,1.1,0.62,0.65,2
2020-07-07,28_2020,21,138,241956,1010,0.32,1.07,0.66,-8,30,34899,43219,5703673,NA,0.99,1.16,0.65,0.68,2
2020-07-08,28_2020,21,193,242149,970,0.38,1.05,0.69,-40,15,34914,50443,5754116,NA,0.97,1.14,0.68,0.71,2
2020-07-09,28_2020,21,229,242363,940,0.44,1.05,0.72,-30,12,34926,52552,5806668,NA,0.97,1.14,0.7,0.74,2
2020-07-10,28_2020,21,276,242639,909,0.58,1.12,0.75,-31,12,34938,47953,5854621,NA,1.03,1.21,0.73,0.76,2
2020-07-11,28_2020,21,188,242827,893,0.41,1.12,0.77,-16,7,34945,45931,5900552,NA,1.04,1.22,0.75,0.79,2
2020-07-12,28_2020,21,234,243061,844,0.61,1.13,0.78,-49,9,34954,38259,5938811,NA,1.05,1.22,0.76,0.8,2
2020-07-13,29_2020,21,169,243230,833,0.71,1.12,0.79,-11,13,34967,23933,5962744,NA,1.04,1.21,0.77,0.81,2
2020-07-14,29_2020,21,114,243344,837,0.27,1.12,0.8,4,17,34984,41867,6004611,NA,1.03,1.21,0.78,0.82,2
2020-07-15,29_2020,21,163,243506,854,0.34,1.1,0.81,17,13,34997,48449,6053060,NA,1.01,1.18,0.79,0.83,2
2020-07-16,29_2020,21,230,243736,803,0.46,1.09,0.82,-51,20,35017,50432,6103492,NA,1.01,1.18,0.8,0.84,2
2020-07-17,29_2020,21,233,243967,821,0.46,1.06,0.83,18,11,35028,50767,6154259,NA,0.98,1.15,0.81,0.85,2
2020-07-18,29_2020,21,249,244216,807,0.52,1.07,0.84,-14,14,35042,48265,6202524,NA,0.99,1.16,0.82,0.86,2
2020-07-19,29_2020,21,219,244434,792,0.62,1.08,0.86,-15,3,35045,35525,6238049,NA,1,1.16,0.84,0.88,2
2020-07-20,30_2020,21,190,244624,792,0.78,1.13,0.87,0,13,35058,24253,6262302,NA,1.05,1.21,0.85,0.9,3
2020-07-21,30_2020,21,129,244752,781,0.3,1.13,0.88,-11,15,35073,43110,6305412,NA,1.05,1.22,0.86,0.91,3
2020-07-22,30_2020,21,282,245032,772,0.57,1.14,0.89,-9,9,35082,49318,6354730,NA,1.06,1.23,0.87,0.91,3
2020-07-23,30_2020,21,306,245338,762,0.51,1.19,0.9,-10,10,35092,60311,6415041,NA,1.11,1.27,0.88,0.92,3
2020-07-24,30_2020,21,252,245590,759,0.47,1.18,0.9,-3,5,35097,53334,6468375,NA,1.1,1.26,0.88,0.93,3
2020-07-25,30_2020,21,275,245864,772,0.53,1.2,0.91,13,5,35102,51671,6520046,NA,1.12,1.28,0.89,0.94,3
2020-07-26,30_2020,21,255,246118,779,0.63,1.18,0.92,7,5,35107,40526,6560572,NA,1.1,1.26,0.9,0.95,3
2020-07-27,31_2020,21,170,246286,785,0.67,1.14,0.94,6,5,35112,25551,6586123,NA,1.07,1.22,0.91,0.96,3
2020-07-28,31_2020,21,212,246488,789,0.44,1.14,0.95,4,11,35123,48170,6634293,NA,1.07,1.22,0.92,0.97,3
2020-07-29,31_2020,21,289,246776,769,0.52,1.14,0.96,-20,6,35129,56018,6690311,NA,1.06,1.21,0.93,0.98,3
2020-07-30,31_2020,21,386,247158,795,0.62,1.09,0.97,26,3,35132,61858,6752169,NA,1.02,1.17,0.95,1,3
2020-07-31,31_2020,21,379,247537,757,0.62,1.08,0.98,-38,9,35141,60944,6813113,NA,1.01,1.16,0.95,1,3
2020-08-01,31_2020,21,295,247832,748,0.49,1.11,0.98,-9,5,35146,60383,6873496,NA,1.03,1.18,0.95,1,3
2020-08-02,31_2020,21,239,248070,750,0.55,1.11,0.98,2,8,35154,43269,6916765,NA,1.04,1.19,0.95,1,3
2020-08-03,32_2020,21,159,248229,775,0.66,1.19,0.98,25,12,35166,24036,6940801,NA,1.12,1.27,0.95,1,4
2020-08-04,32_2020,21,190,248419,802,0.43,1.22,0.98,27,5,35171,43788,6984589,NA,1.15,1.3,0.96,1.01,4
2020-08-05,32_2020,21,384,248803,805,0.68,1.28,0.99,3,10,35181,56451,7041040,NA,1.21,1.36,0.97,1.02,4
2020-08-06,32_2020,21,402,249204,804,0.69,1.33,1,-1,6,35187,58673,7099713,NA,1.26,1.41,0.97,1.02,4
2020-08-07,32_2020,21,552,249756,821,0.93,1.37,1.01,17,3,35190,59196,7158909,NA,1.29,1.44,0.98,1.04,4
2020-08-08,32_2020,21,347,250103,814,0.65,1.4,1.02,-7,13,35203,53298,7212207,NA,1.32,1.47,1,1.05,4
2020-08-09,32_2020,21,463,250566,808,1.23,1.41,1.03,-6,2,35205,37637,7249844,NA,1.34,1.48,1,1.06,4
2020-08-10,33_2020,21,259,250825,825,0.98,1.4,1.04,17,4,35209,26432,7276276,NA,1.33,1.47,1.01,1.06,6
2020-08-11,33_2020,21,412,251237,850,1.01,1.38,1.04,25,6,35215,40642,7316918,NA,1.32,1.45,1.02,1.07,6
2020-08-12,33_2020,21,481,251713,832,0.91,1.36,1.04,-18,10,35225,52658,7369576,NA,1.29,1.43,1.01,1.07,6
2020-08-13,33_2020,21,523,252235,841,1.02,1.36,1.04,9,6,35231,51188,7420764,NA,1.3,1.42,1.02,1.07,6
2020-08-14,33_2020,21,574,252809,827,1.23,1.37,1.04,-14,3,35234,46723,7467487,NA,1.3,1.43,1.01,1.06,6
2020-08-15,33_2020,21,629,253438,819,1.18,1.37,1.03,-8,158,35392,53123,7520610,NA,1.31,1.43,1.01,1.06,6
2020-08-16,33_2020,21,479,253915,843,1.3,1.4,1.03,24,4,35396,36807,7557417,NA,1.34,1.46,1.01,1.06,6
2020-08-17,34_2020,21,320,254235,868,1.04,1.51,1.04,25,4,35400,30666,7588083,NA,1.45,1.57,1.01,1.06,9
2020-08-18,34_2020,21,403,254636,901,0.75,1.63,1.04,33,5,35405,53976,7642059,NA,1.57,1.69,1.01,1.07,9
2020-08-19,34_2020,21,642,255278,932,0.9,1.67,1.05,31,7,35412,71095,7713154,NA,1.62,1.74,1.02,1.08,9
2020-08-20,34_2020,21,845,256118,951,1.09,1.68,1.06,19,6,35418,77442,7790596,NA,1.62,1.74,1.04,1.09,9
2020-08-21,34_2020,21,947,257065,988,1.32,1.69,1.08,37,9,35427,71996,7862592,NA,1.64,1.75,1.06,1.11,9
2020-08-22,34_2020,21,1071,258136,988,1.38,1.65,1.1,0,3,35430,77674,7940266,NA,1.6,1.7,1.07,1.13,9
2020-08-23,34_2020,21,1210,259345,1040,1.8,1.61,1.12,52,7,35437,67371,8007637,NA,1.56,1.66,1.09,1.15,9
2020-08-24,35_2020,21,953,260298,1110,2.08,1.53,1.14,70,4,35441,45914,8053551,NA,1.48,1.57,1.12,1.17,15
2020-08-25,35_2020,21,878,261174,1124,1.21,1.42,1.16,14,4,35445,72341,8125892,NA,1.38,1.46,1.13,1.19,15
2020-08-26,35_2020,21,1367,262540,1124,1.46,1.34,1.17,0,13,35458,93529,8219421,NA,1.3,1.39,1.14,1.19,15
2020-08-27,35_2020,21,1411,263949,1198,1.5,1.27,1.18,74,5,35463,94024,8313445,NA,1.23,1.31,1.15,1.21,15
2020-08-28,35_2020,21,1462,265409,1252,1.51,1.2,1.19,54,9,35472,97065,8410510,NA,1.16,1.24,1.17,1.22,15
2020-08-29,35_2020,21,1444,266853,1247,1.46,1.12,1.2,-5,1,35473,99108,8509618,NA,1.08,1.15,1.18,1.23,15
2020-08-30,35_2020,21,1365,268218,1337,1.78,1.04,1.21,90,4,35477,76723,8586341,NA,1.01,1.07,1.19,1.24,15
2020-08-31,36_2020,21,996,269214,1382,1.7,0.99,1.22,45,6,35483,58518,8644859,NA,0.96,1.02,1.19,1.24,16
2020-09-01,36_2020,21,978,270189,1487,1.21,1.01,1.23,105,8,35491,81050,8725909,NA,0.98,1.04,1.21,1.26,16
2020-09-02,36_2020,21,1326,271515,1546,1.29,1.01,1.25,59,6,35497,102959,8828868,NA,0.97,1.04,1.22,1.27,16
2020-09-03,36_2020,21,1397,272912,1625,1.51,1.01,1.26,79,10,35507,92790,8921658,NA,0.98,1.04,1.24,1.29,16
2020-09-04,36_2020,21,1733,274644,1728,1.53,1.03,1.28,103,11,35518,113085,9034743,NA,0.99,1.06,1.25,1.3,16
2020-09-05,36_2020,21,1694,276337,1741,1.57,1.05,1.29,13,15,35533,107658,9142401,NA,1.02,1.08,1.27,1.31,16
2020-09-06,36_2020,21,1297,277634,1816,1.69,1.07,1.3,75,8,35541,76856,9219257,NA,1.03,1.1,1.27,1.32,16
2020-09-07,37_2020,21,1108,278784,1861,2.11,1.12,1.3,45,12,35553,52553,9271810,NA,1.09,1.15,1.28,1.32,17
2020-09-08,37_2020,21,1370,280153,1903,1.48,1.09,1.29,42,10,35563,92403,9364213,NA,1.06,1.12,1.27,1.31,17
2020-09-09,37_2020,21,1434,281583,1928,1.49,1.09,1.28,25,14,35577,95990,9460203,NA,1.06,1.12,1.26,1.3,17
2020-09-10,37_2020,21,1597,283180,2000,1.7,1.12,1.27,72,10,35587,94186,9554389,NA,1.09,1.15,1.24,1.29,17
2020-09-11,37_2020,21,1616,284796,2024,1.63,1.1,1.25,24,10,35597,98880,9653269,NA,1.07,1.13,1.22,1.27,17
2020-09-12,37_2020,21,1501,286297,2133,1.62,1.11,1.24,109,6,35603,92706,9745975,NA,1.08,1.14,1.22,1.26,17
2020-09-13,37_2020,21,1458,287753,2229,2.02,1.11,1.23,96,7,35610,72143,9818118,NA,1.08,1.14,1.21,1.25,17
2020-09-14,38_2020,21,1008,288761,2319,2.22,1.11,1.23,90,14,35624,45309,9863427,NA,1.08,1.14,1.21,1.25,18
2020-09-15,38_2020,21,1229,289990,2423,1.53,1.14,1.23,104,9,35633,80517,9943944,NA,1.11,1.18,1.21,1.25,18
2020-09-16,38_2020,21,1452,291442,2492,1.44,1.15,1.24,69,12,35645,100607,10044551,NA,1.12,1.19,1.22,1.26,18
2020-09-17,38_2020,21,1585,293025,2560,1.56,1.15,1.24,68,13,35658,101773,10146324,NA,1.12,1.18,1.22,1.26,18
2020-09-18,38_2020,21,1907,294932,2595,1.91,1.17,1.24,35,10,35668,99839,10246163,NA,1.14,1.2,1.22,1.26,18
2020-09-19,38_2020,21,1638,296569,2595,1.59,1.18,1.23,0,24,35692,103223,10349386,NA,1.15,1.21,1.21,1.25,18
2020-09-20,38_2020,21,1587,298156,2587,1.9,1.19,1.22,-8,15,35707,83428,10432814,NA,1.16,1.22,1.2,1.24,18
2020-09-21,39_2020,21,1350,299506,2707,2.42,1.18,1.21,120,17,35724,55862,10488676,NA,1.15,1.21,1.19,1.22,20
2020-09-22,39_2020,21,1392,300897,2843,1.59,1.15,1.2,136,14,35738,87303,10575979,NA,1.12,1.18,1.18,1.21,20
2020-09-23,39_2020,21,1640,302537,2902,1.58,1.14,1.19,59,20,35758,103696,10679675,NA,1.11,1.17,1.17,1.21,20
2020-09-24,39_2020,21,1786,304323,2977,1.65,1.11,1.18,75,23,35781,108019,10787694,NA,1.08,1.14,1.16,1.2,20
2020-09-25,39_2020,21,1912,306235,2981,1.78,1.11,1.17,4,20,35801,107269,10894963,NA,1.09,1.14,1.16,1.19,20
2020-09-26,39_2020,21,1869,308104,2993,1.79,1.11,1.17,12,17,35818,104387,10999350,NA,1.08,1.14,1.15,1.18,20
2020-09-27,39_2020,21,1766,309870,3100,2.01,1.12,1.17,107,17,35835,87714,11087064,NA,1.09,1.15,1.15,1.18,20
2020-09-28,40_2020,21,1494,311364,3241,2.92,1.17,1.17,141,16,35851,51109,11138173,NA,1.14,1.2,1.15,1.18,26
2020-09-29,40_2020,21,1648,313011,3319,1.83,1.2,1.17,78,24,35875,90185,11228358,NA,1.17,1.22,1.15,1.18,26
2020-09-30,40_2020,21,1851,314861,3327,1.75,1.29,1.16,8,19,35894,105564,11333922,NA,1.26,1.32,1.15,1.18,26
2020-10-01,40_2020,21,2548,317409,3388,2.16,1.47,1.16,61,24,35918,118236,11452158,NA,1.44,1.5,1.14,1.17,26
2020-10-02,40_2020,21,2499,319908,3436,2.08,1.57,1.15,48,23,35941,120301,11572459,NA,1.54,1.6,1.14,1.17,26
2020-10-03,40_2020,21,2844,322751,3502,2.39,1.66,1.15,66,27,35968,118932,11691391,NA,1.63,1.69,1.14,1.17,26
2020-10-04,40_2020,21,2578,325329,3590,2.78,1.7,1.15,88,18,35986,92714,11784105,NA,1.67,1.73,1.14,1.17,26
2020-10-05,41_2020,21,2257,327586,3810,3.75,1.78,1.15,220,16,36002,60241,11844346,NA,1.75,1.81,1.14,1.17,50
2020-10-06,41_2020,21,2677,330263,3944,2.68,1.81,1.16,134,28,36030,99742,11944088,NA,1.78,1.84,1.14,1.17,50
2020-10-07,41_2020,21,3678,333940,4119,2.94,1.82,1.17,175,31,36061,125314,12069402,NA,1.79,1.85,1.15,1.18,50
2020-10-08,41_2020,21,4458,338398,4283,3.48,1.78,1.18,164,22,36083,128098,12197500,NA,1.75,1.81,1.17,1.19,50
2020-10-09,41_2020,21,5372,343770,4473,4.15,1.77,1.2,190,28,36111,129471,12326971,NA,1.74,1.79,1.18,1.21,50
2020-10-10,41_2020,21,5724,349494,4726,4.3,1.77,1.22,253,29,36140,133084,12460055,NA,1.75,1.8,1.2,1.23,50
2020-10-11,41_2020,21,5456,354950,4939,5.21,1.72,1.24,213,26,36166,104658,12564713,NA,1.7,1.74,1.22,1.25,50
2020-10-12,42_2020,21,4619,359569,5273,5.41,1.74,1.26,334,39,36205,85442,12650155,NA,1.72,1.76,1.24,1.27,100
2020-10-13,42_2020,21,5901,365467,5590,5.24,1.74,1.28,317,41,36246,112544,12762699,NA,1.72,1.76,1.27,1.29,100
2020-10-14,42_2020,21,7332,372799,6009,4.82,1.72,1.3,419,43,36289,152196,12914895,NA,1.7,1.74,1.29,1.32,100
2020-10-15,42_2020,21,8804,381602,6382,5.4,1.71,1.33,373,83,36372,162932,13077827,NA,1.7,1.73,1.31,1.34,100
2020-10-16,42_2020,21,10010,391611,6816,6.66,1.71,1.35,434,55,36427,150377,13228204,NA,1.7,1.73,1.34,1.37,100
2020-10-17,42_2020,21,10925,402536,7322,6.59,1.68,1.38,506,47,36474,165837,13394041,NA,1.66,1.69,1.36,1.39,100
2020-10-18,42_2020,21,11705,414241,7881,7.99,1.66,1.4,559,69,36543,146541,13540582,NA,1.65,1.68,1.39,1.42,100
2020-10-19,43_2020,21,9338,423578,8473,9.45,1.66,1.43,592,73,36616,98862,13639444,NA,1.65,1.68,1.41,1.44,188
2020-10-20,43_2020,21,10874,434449,9324,7.51,1.68,1.45,851,89,36705,144737,13784181,NA,1.67,1.7,1.44,1.47,188
2020-10-21,43_2020,21,15199,449648,9983,8.55,1.66,1.48,659,127,36832,177848,13962029,NA,1.64,1.67,1.46,1.49,188
2020-10-22,43_2020,21,16079,465726,10686,9.44,1.61,1.49,703,136,36968,170392,14132421,NA,1.6,1.62,1.48,1.51,188
2020-10-23,43_2020,21,19143,484869,11598,10.52,1.57,1.51,912,91,37059,182032,14314453,NA,1.56,1.58,1.5,1.52,188
2020-10-24,43_2020,21,19644,504509,12415,11.06,1.53,1.53,817,151,37210,177669,14492122,NA,1.52,1.54,1.51,1.54,188
2020-10-25,43_2020,21,21273,525782,13214,13.14,1.49,1.53,799,128,37338,161880,14654002,NA,1.48,1.5,1.52,1.54,188
2020-10-26,44_2020,21,17012,542789,14281,13.64,1.47,1.54,1067,141,37479,124686,14778688,NA,1.46,1.48,1.53,1.55,309
2020-10-27,44_2020,21,21994,564778,15366,12.61,1.41,1.54,1085,221,37700,174398,14953086,NA,1.4,1.42,1.53,1.55,309
2020-10-28,44_2020,21,24991,589766,16517,12.56,1.38,1.54,1151,205,37905,198952,15152038,NA,1.37,1.39,1.53,1.55,309
2020-10-29,44_2020,21,26831,616595,17615,13.32,1.35,1.54,1098,217,38122,201452,15353490,NA,1.34,1.36,1.53,1.55,309
2020-10-30,44_2020,21,31084,647674,18740,14.45,1.31,1.54,1125,199,38321,215085,15568575,NA,1.3,1.32,1.53,1.54,309
2020-10-31,44_2020,21,31758,679430,19809,14.71,1.26,1.53,1069,297,38618,215886,15784461,NA,1.25,1.27,1.52,1.54,309
2020-11-01,44_2020,21,29907,709335,20841,16.3,1.25,1.52,1032,208,38826,183457,15967918,NA,1.24,1.26,1.51,1.53,309
2020-11-02,45_2020,21,22253,731588,21862,16.39,1.23,1.5,1021,233,39059,135731,16103649,NA,1.22,1.24,1.49,1.51,381
2020-11-03,45_2020,21,28244,759829,23339,15.49,1.2,1.49,1477,353,39412,182287,16285936,NA,1.19,1.21,1.48,1.5,381
2020-11-04,45_2020,21,30550,790377,24408,14.42,1.17,1.47,1069,335,39747,211831,16497767,NA,1.17,1.18,1.46,1.48,381
2020-11-05,45_2020,0,34505,824879,25647,15.69,1.16,1.45,1239,445,40192,219884,16717651,NA,1.15,1.17,1.45,1.46,381
2020-11-06,45_2020,52,37809,862681,26520,16.14,1.14,1.43,873,446,40638,234245,16951896,NA,1.14,1.15,1.43,1.44,381
2020-11-07,45_2020,52,39811,902490,27743,17.18,1.14,1.42,1223,425,41063,231673,17183569,NA,1.13,1.15,1.41,1.42,381
2020-11-08,45_2020,52,32616,935104,29189,17.06,1.09,1.4,1446,331,41394,191144,17374713,NA,1.09,1.1,1.39,1.41,381
2020-11-09,46_2020,52,25271,960373,30485,17.11,1.07,1.39,1296,356,41750,147725,17522438,NA,1.06,1.07,1.38,1.39,410
2020-11-10,46_2020,59,35098,995463,31604,16.12,1.06,1.37,1119,580,42330,217758,17740196,NA,1.06,1.07,1.37,1.38,410
2020-11-11,46_2020,59,32961,1028424,32525,14.61,1.04,1.36,921,623,42953,225640,17965836,NA,1.03,1.04,1.35,1.36,410
2020-11-12,46_2020,59,37978,1066401,33043,16.18,1.01,1.34,518,636,43589,234672,18200508,NA,1.01,1.02,1.33,1.34,410
2020-11-13,46_2020,59,40902,1107303,34144,16.05,0.99,1.32,1101,550,44139,254908,18455416,NA,0.99,1,1.31,1.32,410
2020-11-14,46_2020,65,37255,1144552,34704,16.36,0.98,1.3,560,544,44683,227695,18683111,NA,0.97,0.99,1.29,1.3,410
2020-11-15,46_2020,65,33979,1178529,35469,17.4,0.97,1.28,765,546,45229,195275,18878386,NA,0.96,0.98,1.27,1.28,410
2020-11-16,47_2020,65,27354,1205881,36028,17.92,0.95,1.26,559,504,45733,152663,19031049,NA,0.94,0.95,1.25,1.26,388
2020-11-17,47_2020,65,32191,1238072,36686,15.44,0.91,1.23,658,731,46464,208458,19239507,NA,0.9,0.92,1.23,1.24,388
2020-11-18,47_2020,65,34282,1272352,37174,14.6,0.9,1.21,488,753,47217,234834,19474341,NA,0.89,0.9,1.21,1.22,388
2020-11-19,47_2020,65,36176,1308528,37322,14.46,0.87,1.2,148,653,47870,250186,19724527,NA,0.87,0.88,1.19,1.2,388
2020-11-20,47_2020,65,37242,1345767,37705,15.64,0.86,1.18,383,699,48569,238077,19962604,NA,0.85,0.86,1.17,1.18,388
2020-11-21,47_2020,66,34767,1380531,37821,14.66,0.83,1.16,116,692,49261,237225,20199829,NA,0.82,0.83,1.15,1.16,388
2020-11-22,47_2020,66,28337,1408868,38080,15.01,0.8,1.14,259,562,49823,188747,20388576,NA,0.8,0.81,1.14,1.14,388
2020-11-23,48_2020,66,22930,1431795,38507,15.39,0.78,1.13,427,630,50453,148945,20537521,NA,0.78,0.79,1.12,1.13,297
2020-11-24,48_2020,66,23232,1455022,38393,12.31,0.78,1.11,-114,853,51306,188659,20726180,NA,0.77,0.78,1.11,1.11,297
2020-11-25,48_2020,66,25853,1480874,38161,11.24,0.77,1.09,-232,722,52028,230007,20956187,NA,0.76,0.77,1.09,1.1,297
2020-11-26,48_2020,66,29003,1509875,37884,12.46,0.78,1.08,-277,822,52850,232711,21188898,NA,0.77,0.78,1.07,1.08,297
2020-11-27,48_2020,66,28352,1538217,37466,12.73,0.77,1.06,-418,827,53677,222803,21411701,NA,0.76,0.78,1.06,1.07,297
2020-11-28,48_2020,61,26323,1564532,37061,11.65,0.79,1.05,-405,686,54363,225940,21637641,NA,0.78,0.8,1.04,1.05,297
2020-11-29,48_2020,61,20648,1585178,36632,11.67,0.8,1.03,-429,541,54904,176934,21814575,NA,0.79,0.8,1.03,1.04,297
2020-11-30,49_2020,61,16377,1601554,36931,12.55,0.81,1.02,299,672,55576,130524,21945099,NA,0.8,0.82,1.02,1.02,242
2020-12-01,49_2020,61,19350,1620901,36474,10.63,0.85,1.01,-457,785,56361,182100,22127199,NA,0.84,0.86,1,1.01,242
2020-12-02,49_2020,61,20709,1641610,36070,10,0.86,1,-404,684,57045,207143,22334342,NA,0.86,0.87,0.99,1,242
2020-12-03,49_2020,61,23225,1664829,35369,10.55,0.88,0.98,-701,993,58038,220047,22554389,NA,0.87,0.89,0.98,0.99,242
2020-12-04,49_2020,61,24099,1688939,34767,11.33,0.9,0.97,-602,814,58852,212741,22767130,NA,0.89,0.9,0.97,0.98,242
2020-12-05,49_2020,56,21052,1709991,33675,10.8,0.9,0.96,-1092,662,59514,194984,22962114,NA,0.89,0.91,0.96,0.97,242
2020-12-06,49_2020,56,18887,1728878,33845,11.55,0.92,0.96,170,564,60078,163550,23125664,NA,0.91,0.92,0.95,0.96,242
2020-12-07,50_2020,56,13720,1742557,33906,12.34,0.91,0.95,61,528,60606,111217,23236881,NA,0.91,0.92,0.95,0.95,194
2020-12-08,50_2020,56,14842,1757394,33426,9.95,0.88,0.94,-480,634,61240,149232,23386113,NA,0.88,0.89,0.94,0.95,194
2020-12-09,50_2020,56,12756,1770149,32973,10.77,0.89,0.94,-453,499,61739,118475,23504588,NA,0.88,0.9,0.93,0.94,194
2020-12-10,50_2020,56,16999,1787147,32379,9.91,0.91,0.93,-594,887,62626,171586,23676174,NA,0.9,0.92,0.93,0.94,194
2020-12-11,50_2020,56,18727,1805873,31827,9.83,0.91,0.93,-552,761,63387,190416,23866590,NA,0.9,0.92,0.93,0.93,194
2020-12-12,50_2020,47,19903,1825775,31265,10.13,0.92,0.93,-562,649,64036,196439,24063029,NA,0.91,0.93,0.93,0.93,194
2020-12-13,50_2020,47,17938,1843712,30893,11.75,0.94,0.93,-372,484,64520,152697,24215726,NA,0.93,0.95,0.92,0.93,194
2020-12-14,51_2020,47,12030,1855737,30860,11.61,0.96,0.92,-33,491,65011,103584,24319310,NA,0.95,0.97,0.92,0.93,189
2020-12-15,51_2020,47,14844,1870576,30345,9.03,0.98,0.92,-515,846,65857,164431,24483741,NA,0.97,0.99,0.92,0.93,189
2020-12-16,51_2020,47,17572,1888144,29823,8.81,0.98,0.92,-522,680,66537,199489,24683230,NA,0.97,0.99,0.91,0.92,189
2020-12-17,51_2020,47,18236,1906377,29282,10.81,0.97,0.92,-541,683,67220,-47510,24635720,NA,0.96,0.98,0.91,0.92,189
2020-12-18,51_2020,47,17992,1921778,28588,10.01,0.98,0.91,-694,674,67894,179800,24815520,NA,0.97,0.98,0.91,0.92,189
2020-12-19,51_2020,47,16308,1938083,28148,9.26,0.97,0.91,-440,553,68447,176185,24991705,NA,0.97,0.98,0.91,0.92,189
2020-12-20,51_2020,47,15104,1953185,27901,10.99,1,0.91,-247,352,68799,137420,25129125,NA,0.99,1.01,0.91,0.91,189
2020-12-21,52_2020,47,10872,1964054,27876,12.37,1,0.91,-25,415,69214,87889,25217014,NA,0.99,1.01,0.9,0.91,160
2020-12-22,52_2020,47,13318,1977370,27635,8.44,1.01,0.91,-241,628,69842,157705,25374719,NA,1,1.02,0.9,0.91,160
2020-12-23,52_2020,47,14522,1991278,27170,7.9,1.02,0.91,-465,553,70395,183864,25558583,NA,1.01,1.03,0.91,0.91,160
2020-12-24,52_2020,47,18040,2009317,26659,9.31,1.05,0.91,-511,505,70900,193777,25752360,NA,1.04,1.06,0.91,0.91,160
2020-12-25,52_2020,47,19037,2028354,25986,12.5,1.05,0.91,-673,459,71359,152334,25904694,NA,1.04,1.05,0.91,0.91,160
2020-12-26,52_2020,47,10431,2038783,25892,12.79,1.07,0.91,-94,268,71627,81564,25986258,NA,1.06,1.08,0.91,0.92,160
2020-12-27,52_2020,47,8913,2047696,26151,14.89,1.08,0.92,259,298,71925,59879,26046137,7350,1.08,1.09,0.91,0.92,160
2020-12-28,53_2020,47,8585,2056277,26497,12.5,1.12,0.92,346,445,72370,68681,26114818,1505,1.11,1.13,0.92,0.92,182
2020-12-29,53_2020,47,11224,2067487,26211,8.72,1.13,0.93,-286,659,73029,128740,26243558,1099,1.12,1.13,0.92,0.93,182
2020-12-30,53_2020,47,16202,2083689,26094,9.58,1.12,0.93,-117,575,73604,169045,26412603,4887,1.11,1.13,0.93,0.94,182
2020-12-31,53_2020,47,23477,2107166,25706,12.62,1.1,0.94,-388,555,74159,186004,26598607,25949,1.1,1.11,0.93,0.94,182
2021-01-01,53_2020,47,22211,2129376,25375,14.1,1.12,0.94,-331,462,74621,157524,26756131,11275,1.11,1.13,0.94,0.95,182
2021-01-02,53_2020,47,11831,2141201,25517,17.61,1.11,0.95,142,364,74985,67174,26823305,39081,1.1,1.12,0.95,0.95,182
2021-01-03,53_2020,47,14245,2155446,25658,13.83,1.08,0.96,141,347,75332,102974,26926279,35883,1.07,1.09,0.95,0.96,182
2021-01-04,1_2021,47,10800,2166244,25896,13.85,1.06,0.96,238,348,75680,77993,27004272,69631,1.05,1.07,0.96,0.96,204
2021-01-05,1_2021,47,15378,2181619,25964,11.38,1.05,0.97,68,649,76329,135106,27139378,80262,1.04,1.06,0.96,0.97,204
2021-01-06,1_2021,47,20331,2201945,25745,11.38,1.01,0.97,-219,548,76877,178596,27317974,65185,1.01,1.02,0.96,0.97,204
2021-01-07,1_2021,47,18020,2220361,25878,14.86,1,0.98,133,414,77291,121275,27439249,92662,0.99,1,0.97,0.98,204
2021-01-08,1_2021,47,17533,2237890,25900,12.5,0.96,0.98,22,620,77911,140267,27579516,96996,0.96,0.97,0.98,0.99,204
2021-01-09,1_2021,52,19978,2257866,25853,11.61,0.93,0.99,-47,483,78394,172119,27751635,88270,0.92,0.94,0.98,0.99,204
2021-01-10,1_2021,52,18627,2276491,26042,13.33,0.9,0.99,189,361,78755,139758,27891393,60935,0.9,0.91,0.99,1,204
2021-01-11,2_2021,52,12532,2289021,26245,13.67,0.86,1,203,448,79203,91656,27983049,82205,0.85,0.87,0.99,1,177
2021-01-12,2_2021,52,14242,2303263,26348,10.05,0.83,1,103,616,79819,141641,28124690,83553,0.82,0.83,1,1,177
2021-01-13,2_2021,52,15774,2319036,26104,8.99,0.82,1,-244,507,80326,175429,28300119,95496,0.81,0.82,1,1.01,177
2021-01-14,2_2021,52,17246,2336279,25667,10.74,0.8,1,-437,522,80848,160585,28460704,94579,0.8,0.81,1,1.01,177
2021-01-15,2_2021,52,16146,2352423,25363,5.9,0.8,1,-304,477,81325,273506,28734210,91045,0.79,0.81,0.99,1,177
2021-01-16,2_2021,62,16310,2368733,25304,6.24,0.8,1,-59,475,81800,261404,28995614,66135,0.8,0.81,0.99,1,177
2021-01-17,2_2021,62,12545,2381277,25260,5.94,0.8,0.99,-44,377,82177,211078,29206692,37641,0.8,0.81,0.99,1,177
2021-01-18,3_2021,62,8825,2390102,25428,5.56,0.82,0.99,168,377,82554,158674,29365366,44706,0.81,0.82,0.98,0.99,145
2021-01-19,3_2021,62,10497,2400598,25186,4.13,0.83,0.98,-242,603,83157,254070,29619436,33628,0.83,0.84,0.98,0.99,145
2021-01-20,3_2021,62,13571,2414166,24930,4.85,0.87,0.98,-256,524,83681,279762,29899198,31535,0.86,0.88,0.97,0.98,145
2021-01-21,3_2021,62,14078,2428221,24463,5.26,0.89,0.97,-467,521,84202,267567,30166765,36580,0.88,0.9,0.97,0.98,145
2021-01-22,3_2021,62,13633,2441854,24081,5.15,0.91,0.97,-382,472,84674,264728,30431493,27451,0.9,0.92,0.97,0.97,145
2021-01-23,3_2021,62,13331,2455185,23789,4.66,0.93,0.97,-292,488,85162,286331,30717824,39381,0.92,0.94,0.96,0.97,145
2021-01-24,3_2021,62,11629,2466813,23709,5.38,0.96,0.96,-80,299,85461,216211,30934035,34043,0.95,0.97,0.96,0.97,145
2021-01-25,4_2021,62,8562,2475372,23845,6.75,0.97,0.96,136,420,85881,126931,31060966,69650,0.96,0.98,0.95,0.96,146
2021-01-26,4_2021,62,10593,2485956,23727,4.13,0.98,0.95,-118,541,86422,256287,31317253,80872,0.97,0.98,0.95,0.96,146
2021-01-27,4_2021,62,15204,2501147,23513,5.18,0.97,0.95,-214,467,86889,293770,31611023,71256,0.96,0.98,0.95,0.96,146
2021-01-28,4_2021,62,14372,2515507,23066,5.22,0.97,0.95,-447,492,87381,275579,31886602,94255,0.97,0.98,0.95,0.95,146
2021-01-29,4_2021,62,13574,2529070,22667,5.05,0.97,0.95,-399,477,87858,268750,32155352,99177,0.96,0.98,0.94,0.95,146
2021-01-30,4_2021,62,12715,2541783,22316,4.27,0.96,0.95,-351,421,88279,298010,32453362,90796,0.95,0.97,0.94,0.95,146
2021-01-31,4_2021,56,11252,2553032,22311,5.27,0.96,0.95,-5,237,88516,213364,32666726,60009,0.95,0.96,0.94,0.95,146
2021-02-01,5_2021,56,7925,2560957,22512,5.56,0.98,0.95,201,329,88845,142419,32809145,86260,0.97,0.99,0.94,0.95,142
2021-02-02,5_2021,56,9660,2570608,22531,3.95,1,0.95,19,498,89343,244429,33053574,88641,0.99,1.01,0.94,0.95,142
2021-02-03,5_2021,56,13189,2583790,22216,4.72,1.01,0.95,-315,476,89819,279307,33332881,100295,1,1.02,0.94,0.95,142
2021-02-04,5_2021,56,13659,2597446,21894,5.06,1.02,0.95,-322,422,90241,270142,33603023,109035,1.01,1.03,0.94,0.95,142
2021-02-05,5_2021,56,14218,2611659,21717,5.26,1.03,0.95,-177,377,90618,270507,33873530,108239,1.02,1.04,0.94,0.95,142
2021-02-06,5_2021,56,13442,2625098,21518,4.76,1.05,0.95,-199,385,91003,282407,34155937,78101,1.04,1.06,0.95,0.96,142
2021-02-07,5_2021,56,11641,2636738,21373,5.63,1.06,0.95,-145,270,91273,206789,34362726,42437,1.05,1.07,0.95,0.96,142
2021-02-08,6_2021,56,7970,2644707,21670,5.52,1.04,0.95,297,307,91580,144270,34506996,67271,1.03,1.05,0.95,0.96,144
2021-02-09,6_2021,56,10630,2655319,21655,3.88,1.03,0.96,-15,422,92002,274263,34781259,67290,1.02,1.04,0.95,0.96,144
2021-02-10,6_2021,55,12956,2668266,21408,4.17,1.04,0.96,-247,336,92338,310994,35092253,73357,1.03,1.05,0.95,0.96,144
2021-02-11,6_2021,55,15146,2683403,21068,5.18,1.03,0.96,-340,391,92729,292533,35384786,75332,1.02,1.04,0.95,0.96,144
2021-02-12,6_2021,55,13908,2697296,20831,4.84,1.02,0.96,-237,316,93045,287619,35672405,74612,1.01,1.03,0.95,0.96,144
2021-02-13,6_2021,56,13532,2710819,20562,4.66,1.01,0.96,-269,311,93356,290534,35962939,52942,1,1.02,0.95,0.96,144
2021-02-14,6_2021,56,11068,2721879,20534,5.38,1.01,0.96,-28,221,93577,205642,36168581,30032,1,1.02,0.95,0.96,144
2021-02-15,7_2021,56,7351,2729223,20604,4.1,1.02,0.96,70,258,93835,179278,36347859,63024,1.01,1.03,0.95,0.96,148
2021-02-16,7_2021,56,10386,2739591,20537,3.79,1.04,0.96,-67,336,94171,274019,36621878,71507,1.03,1.05,0.95,0.96,148
2021-02-17,7_2021,56,12074,2751657,20317,4.1,1.06,0.96,-220,369,94540,294411,36916289,80773,1.05,1.07,0.95,0.96,148
2021-02-18,7_2021,56,13762,2765412,20008,4.77,1.11,0.95,-309,342,94882,288458,37204747,90636,1.1,1.12,0.95,0.96,148
2021-02-19,7_2021,56,15479,2780882,19890,5.21,1.14,0.95,-118,353,95235,297128,37501875,93694,1.13,1.15,0.95,0.96,148
2021-02-20,7_2021,58,14931,2795796,19788,4.88,1.19,0.96,-102,251,95486,306078,37807953,78611,1.18,1.2,0.95,0.96,148
2021-02-21,7_2021,58,13452,2809246,19898,5.36,1.22,0.96,110,232,95718,250986,38058939,51261,1.21,1.23,0.95,0.96,148
2021-02-22,8_2021,58,9630,2818863,20273,5.64,1.26,0.96,375,274,95992,170672,38229611,106245,1.25,1.27,0.96,0.97,196
2021-02-23,8_2021,58,13314,2832162,20441,4.38,1.27,0.97,168,356,96348,303850,38533461,107043,1.26,1.28,0.96,0.97,196
2021-02-24,8_2021,58,16424,2848564,20374,4.83,1.27,0.97,-67,318,96666,340247,38873708,122770,1.26,1.28,0.97,0.98,196
2021-02-25,8_2021,58,19886,2868435,20425,5.62,1.25,0.98,51,308,96974,353704,39227412,129016,1.24,1.26,0.98,0.99,196
2021-02-26,8_2021,58,20499,2888923,20486,6.3,1.25,0.99,61,253,97227,325404,39552816,139248,1.24,1.25,0.98,0.99,196
2021-02-27,8_2021,58,18916,2907825,20588,5.86,1.22,1,102,280,97507,323047,39875863,127169,1.21,1.23,0.99,1,196
2021-02-28,8_2021,60,17455,2925265,20869,6.79,1.2,1.01,281,192,97699,257024,40132887,78516,1.19,1.2,1,1.01,196
2021-03-01,9_2021,60,13114,2938371,21401,7.69,1.22,1.01,532,246,97945,170633,40303520,136202,1.21,1.23,1.01,1.02,241
2021-03-02,9_2021,60,17083,2955434,21897,5.08,1.21,1.02,496,343,98288,335983,40639503,162546,1.21,1.22,1.02,1.03,241
2021-03-03,9_2021,60,20884,2976274,22174,5.82,1.21,1.03,277,347,98635,358884,40998387,188033,1.2,1.22,1.03,1.04,241
2021-03-04,9_2021,60,22865,2999119,22632,6.73,1.2,1.05,458,339,98974,339635,41338022,198865,1.19,1.21,1.04,1.05,241
2021-03-05,9_2021,60,24036,3023129,22899,6.35,1.2,1.06,267,297,99271,378463,41716485,207066,1.19,1.21,1.05,1.06,241
2021-03-06,9_2021,62,23641,3046762,23272,6.66,1.2,1.07,373,307,99578,355024,42071509,178683,1.19,1.21,1.06,1.07,241
2021-03-07,9_2021,62,20765,3067486,23749,7.65,1.19,1.08,477,207,99785,271336,42342845,103256,1.19,1.2,1.07,1.08,241
2021-03-08,10_2021,62,13902,3081368,24531,7.53,1.16,1.09,782,318,100103,184684,42527529,182454,1.16,1.17,1.08,1.1,264
2021-03-09,10_2021,62,19749,3101093,25149,5.71,1.14,1.1,618,376,100479,345972,42873501,196142,1.13,1.15,1.09,1.1,264
2021-03-10,10_2021,62,22409,3123368,25709,6.21,1.14,1.11,560,332,100811,361040,43234541,216622,1.13,1.15,1.1,1.11,264
2021-03-11,10_2021,62,25673,3149017,26106,6.9,1.12,1.12,397,373,101184,372217,43606758,225367,1.11,1.13,1.11,1.12,264
2021-03-12,10_2021,62,26824,3175807,26570,7.26,1.1,1.12,464,380,101564,369636,43976394,213359,1.09,1.11,1.12,1.13,264
2021-03-13,10_2021,72,26062,3201838,27135,6.99,1.08,1.13,565,317,101881,372944,44349338,177682,1.07,1.09,1.12,1.13,264
2021-03-14,10_2021,72,21315,3223142,27600,7.78,1.06,1.13,465,264,102145,273966,44623304,106109,1.06,1.07,1.13,1.14,264
2021-03-15,11_2021,72,15267,3238394,28495,8.53,1.05,1.14,895,354,102499,179015,44802319,175876,1.04,1.05,1.13,1.14,259
2021-03-16,11_2021,72,20396,3258770,29354,5.52,1.03,1.14,859,502,103001,369375,45171694,140915,1.02,1.04,1.13,1.15,259
2021-03-17,11_2021,72,23059,3281810,29834,6.25,1,1.14,480,431,103432,369084,45540778,166393,1,1.01,1.14,1.15,259
2021-03-18,11_2021,72,24935,3306711,30027,7.05,0.99,1.14,193,423,103855,353737,45894515,164244,0.99,1,1.14,1.15,259
2021-03-19,11_2021,72,25735,3332418,30222,7.05,0.98,1.14,195,386,104241,364822,46259337,176808,0.97,0.99,1.13,1.14,259
2021-03-20,11_2021,73,23832,3356331,30448,6.72,0.98,1.14,226,401,104642,354480,46613817,176458,0.97,0.99,1.13,1.14,259
2021-03-21,11_2021,73,20159,3376376,30932,7.28,0.97,1.13,484,300,104942,277086,46890903,130797,0.96,0.98,1.13,1.14,259
2021-03-22,12_2021,73,13846,3400877,31559,8.18,0.96,1.13,627,386,105328,169196,47060099,196789,0.96,0.97,1.12,1.13,245
2021-03-23,12_2021,73,18765,3419616,31974,5.6,0.96,1.12,415,551,105879,335189,47395288,227227,0.96,0.97,1.11,1.12,245
2021-03-24,12_2021,73,21267,3440862,32026,5.85,0.96,1.11,52,460,106339,363767,47759055,258430,0.95,0.96,1.11,1.11,245
2021-03-25,12_2021,73,23798,3464645,32044,6.81,0.96,1.1,18,460,106799,349472,48108527,271899,0.95,0.97,1.1,1.11,245
2021-03-26,12_2021,73,23987,3488619,32100,6.76,0.95,1.09,56,457,107256,354982,48463509,272935,0.95,0.96,1.09,1.1,245
2021-03-27,12_2021,77,23776,3512390,32256,6.66,0.94,1.09,156,380,107636,357076,48820585,241594,0.93,0.94,1.08,1.09,245
2021-03-28,12_2021,77,19611,3531994,32380,7.19,0.93,1.08,124,297,107933,272703,49093288,163778,0.92,0.94,1.07,1.08,245
2021-03-29,13_2021,77,12916,3544894,32884,8.24,0.92,1.07,504,417,108350,156697,49249985,244481,0.91,0.92,1.07,1.08,231
2021-03-30,13_2021,77,16013,3560945,32947,5.31,0.9,1.06,63,529,108879,301447,49551432,271035,0.9,0.91,1.06,1.07,231
2021-03-31,13_2021,77,22516,3583444,32890,6.41,0.88,1.06,-57,467,109346,351065,49902497,307661,0.88,0.89,1.05,1.06,231
2021-04-01,13_2021,77,23649,3607083,32630,6.64,0.88,1.05,-260,501,109847,356245,50258742,289066,0.87,0.88,1.05,1.05,231
2021-04-02,13_2021,77,21932,3629000,32408,6.62,0.86,1.04,-222,481,110328,331154,50589896,284002,0.85,0.87,1.04,1.05,231
2021-04-03,13_2021,74,21261,3650247,32203,5.92,0.84,1.03,-205,376,110704,359214,50949110,231116,0.84,0.85,1.03,1.04,231
2021-04-04,13_2021,74,18025,3668264,32135,7.18,0.83,1.03,-68,326,111030,250933,51200043,96344,0.82,0.83,1.02,1.03,231
2021-04-05,14_2021,74,10680,3678944,32522,10.39,0.79,1.02,387,296,111326,102795,51302838,171647,0.79,0.8,1.02,1.02,172
2021-04-06,14_2021,74,7767,3686707,33080,6.88,0.79,1.02,558,421,111747,112962,51415800,287304,0.79,0.8,1.01,1.02,172
2021-04-07,14_2021,74,13708,3700393,32999,4.03,0.81,1.01,-81,627,112374,339939,51755739,335430,0.8,0.82,1.01,1.02,172
2021-04-08,14_2021,74,17221,3717602,32514,4.76,0.81,1.01,-485,487,112861,362162,52117901,340296,0.8,0.82,1.01,1.01,172
2021-04-09,14_2021,74,18938,3736526,31749,5.43,0.82,1.01,-765,718,113579,349003,52466904,337229,0.81,0.82,1,1.01,172
2021-04-10,14_2021,69,17567,3754077,31242,5.25,0.84,1,-507,344,113923,334862,52801766,322075,0.84,0.85,1,1,172
2021-04-11,14_2021,69,15746,3769814,30836,6.22,0.87,0.99,-406,331,114254,253100,53054866,202538,0.86,0.88,0.99,1,172
2021-04-12,15_2021,69,9789,3779594,30922,5.13,0.91,0.99,86,358,114612,190635,53245501,268418,0.9,0.92,0.98,0.99,170
2021-04-13,15_2021,69,13447,3793033,30478,4.41,0.91,0.98,-444,476,115088,304990,53550491,290676,0.9,0.92,0.97,0.98,170
2021-04-14,15_2021,69,16168,3809193,29859,4.83,0.91,0.96,-619,469,115557,334766,53885257,322676,0.9,0.91,0.96,0.97,170
2021-04-15,15_2021,69,16974,3826156,29004,5.31,0.9,0.95,-855,380,115937,319633,54204890,353304,0.89,0.91,0.95,0.96,170
2021-04-16,15_2021,69,15943,3842079,28109,4.87,0.91,0.94,-895,429,116366,327704,54532594,381880,0.9,0.92,0.94,0.94,170
2021-04-17,15_2021,68,15370,3857443,27440,4.63,0.9,0.93,-669,310,116676,331734,54864328,360998,0.89,0.91,0.93,0.93,170
2021-04-18,15_2021,68,12694,3870131,26959,5.52,0.91,0.92,-481,251,116927,230116,55094444,242639,0.9,0.91,0.92,0.92,170
2021-04-19,16_2021,68,8864,3878994,26986,6.04,0.91,0.91,27,316,117243,146728,55241172,312095,0.9,0.91,0.91,0.92,157
2021-04-20,16_2021,68,12074,3891063,26406,4.11,0.92,0.9,-580,390,117633,294045,55535217,335102,0.91,0.92,0.9,0.91,157
2021-04-21,16_2021,68,13844,3904899,25860,3.96,0.93,0.9,-546,364,117997,350034,55885251,374669,0.92,0.94,0.89,0.9,157
2021-04-22,16_2021,68,16050,3920945,25115,4.4,0.94,0.89,-745,360,118357,364804,56250055,400867,0.93,0.95,0.89,0.9,157
2021-04-23,16_2021,68,14761,3935703,24419,4.68,0.94,0.89,-696,342,118699,315700,56565755,407188,0.94,0.95,0.88,0.89,157
2021-04-24,16_2021,49,13817,3949517,23865,4.31,0.95,0.88,-554,322,119021,320780,56886535,388132,0.95,0.96,0.88,0.89,157
2021-04-25,16_2021,49,13158,3962674,23524,5.49,0.95,0.88,-341,217,119238,239482,57126017,268212,0.94,0.96,0.88,0.89,157
2021-04-26,17_2021,49,8444,3971114,23484,5.79,0.94,0.88,-40,301,119539,145819,57271836,345792,0.93,0.95,0.88,0.88,139
2021-04-27,17_2021,49,10404,3981512,23060,3.44,0.92,0.88,-424,373,119912,302734,57574570,374933,0.92,0.93,0.87,0.88,139
2021-04-28,17_2021,49,13385,3994894,22571,3.98,0.91,0.88,-489,344,120256,336336,57910906,410678,0.9,0.92,0.87,0.88,139
2021-04-29,17_2021,49,14320,4009208,21991,4.34,0.88,0.88,-580,288,120544,330075,58240981,531738,0.87,0.89,0.87,0.88,139
2021-04-30,17_2021,49,13446,4022653,21523,3.97,0.85,0.88,-468,263,120807,338771,58579752,530471,0.85,0.86,0.87,0.88,139
2021-05-01,17_2021,49,12965,4035617,20903,3.43,0.85,0.88,-620,226,121033,378202,58957954,434324,0.84,0.85,0.87,0.88,139
2021-05-02,17_2021,49,9148,4044762,20869,5.83,0.83,0.88,-34,144,121177,156872,59114826,370799,0.82,0.84,0.87,0.88,139
2021-05-03,18_2021,49,5948,4050708,20885,4.88,0.81,0.88,16,256,121433,121829,59236655,414111,0.8,0.82,0.88,0.88,113
2021-05-04,18_2021,49,9116,4059821,20599,2.89,0.8,0.88,-286,305,121738,315506,59552161,453863,0.79,0.81,0.88,0.89,113
2021-05-05,18_2021,49,10585,4070400,19888,3.24,0.8,0.88,-711,267,122005,327169,59879330,487383,0.79,0.81,0.88,0.89,113
2021-05-06,18_2021,49,11807,4082198,19175,3.64,0.79,0.88,-713,258,122263,324640,60203970,522577,0.79,0.8,0.88,0.89,113
2021-05-07,18_2021,49,10554,4092747,18584,3.21,0.79,0.88,-591,207,122470,328612,60532582,546762,0.79,0.8,0.87,0.88,113
2021-05-08,18_2021,45,10176,4102921,18010,3.01,0.78,0.88,-574,224,122694,338436,60871018,514595,0.77,0.79,0.87,0.88,113
2021-05-09,18_2021,45,8292,4111210,17612,3.67,0.77,0.87,-398,139,122833,226006,61097024,384163,0.77,0.78,0.87,0.88,113
2021-05-10,19_2021,45,5080,4116287,17585,3.91,0.76,0.87,-27,198,123031,130000,61227024,442462,0.75,0.77,0.86,0.87,81
2021-05-11,19_2021,45,6946,4123230,16993,2.43,0.75,0.86,-592,251,123282,286428,61513452,458901,0.74,0.76,0.86,0.86,81
2021-05-12,19_2021,45,7852,4131078,16272,2.56,0.73,0.85,-721,262,123544,306744,61820196,486233,0.72,0.74,0.85,0.86,81
2021-05-13,19_2021,45,8085,4139160,15501,2.82,0.73,0.85,-771,201,123745,287026,62107222,530661,0.72,0.73,0.84,0.85,81
2021-05-14,19_2021,45,7567,4146722,14910,2.54,0.71,0.84,-591,182,123927,298186,62405408,556667,0.71,0.72,0.83,0.84,81
2021-05-15,19_2021,43,6659,4153374,14298,2.26,0.71,0.83,-612,136,124063,294686,62700094,545996,0.7,0.72,0.83,0.84,81
2021-05-16,19_2021,43,5753,4159122,13913,2.84,0.71,0.82,-385,93,124156,202573,62902667,410513,0.7,0.72,0.82,0.83,81
2021-05-17,20_2021,43,3455,4162576,13778,2.91,0.68,0.82,-135,140,124296,118924,63021591,468342,0.67,0.69,0.81,0.82,56
2021-05-18,20_2021,43,4452,4167025,13228,1.69,0.68,0.81,-550,201,124497,262864,63284455,470873,0.67,0.69,0.8,0.81,56
2021-05-19,20_2021,43,5506,4172525,12661,1.92,0.68,0.8,-567,149,124646,287256,63571711,488618,0.67,0.69,0.8,0.81,56
2021-05-20,20_2021,43,5741,4178261,11927,2.29,0.68,0.8,-734,164,124810,251037,63822748,555255,0.67,0.69,0.79,0.8,56
2021-05-21,20_2021,43,5218,4183476,11394,1.93,0.68,0.79,-533,218,125028,269744,64092492,573322,0.67,0.69,0.79,0.8,56
2021-05-22,20_2021,42,4717,4188190,10918,1.65,0.67,0.79,-476,125,125153,286603,64379095,523413,0.66,0.69,0.78,0.79,56
2021-05-23,20_2021,42,3995,4192183,10571,2.23,0.68,0.78,-347,72,125225,179391,64558486,407991,0.67,0.69,0.78,0.79,56
2021-05-24,21_2021,42,2490,4194672,10332,2.32,0.69,0.77,-239,110,125335,107481,64665967,465521,0.67,0.7,0.77,0.78,40
2021-05-25,21_2021,42,3224,4197892,9880,1.28,0.68,0.77,-452,166,125501,252646,64918613,480676,0.67,0.69,0.76,0.77,40
2021-05-26,21_2021,42,3937,4201827,9396,1.51,0.69,0.76,-484,121,125622,260962,65179575,528912,0.67,0.7,0.76,0.77,40
2021-05-27,21_2021,42,4147,4205970,8913,1.7,0.69,0.76,-483,171,125793,243967,65423542,591737,0.68,0.7,0.75,0.76,40
2021-05-28,21_2021,42,3738,4209707,8334,1.5,0.7,0.75,-579,126,125919,249911,65673453,596001,0.69,0.72,0.75,0.76,40
2021-05-29,21_2021,39,3351,4213055,7895,1.35,0.71,0.75,-439,83,126002,247330,65920783,525343,0.7,0.72,0.74,0.75,40
2021-05-30,21_2021,39,2949,4216003,7652,1.79,0.71,0.74,-243,44,126046,164495,66085278,402537,0.7,0.73,0.74,0.75,40
2021-05-31,22_2021,39,1820,4217821,7515,2.09,0.7,0.74,-137,82,126128,86977,66172255,480781,0.69,0.71,0.73,0.74,28
2021-06-01,22_2021,39,2483,4220304,7181,1.12,0.71,0.73,-334,93,126221,221818,66394073,470239,0.69,0.72,0.73,0.74,28
2021-06-02,22_2021,39,2897,4223200,6791,1.28,0.71,0.73,-390,62,126283,226272,66620345,412966,0.69,0.72,0.72,0.74,28
2021-06-03,22_2021,39,1968,4225163,6609,2.02,0.71,0.73,-182,59,126342,97633,66717978,598682,0.7,0.73,0.72,0.73,28
2021-06-04,22_2021,39,2557,4227719,6324,1.16,0.72,0.73,-285,73,126415,220939,66938917,634118,0.7,0.74,0.72,0.74,28
2021-06-05,22_2021,35,2436,4230153,5981,1.02,0.73,0.73,-343,57,126472,238632,67177549,619138,0.72,0.75,0.73,0.74,28
2021-06-06,22_2021,35,2275,4232428,5737,1.52,0.73,0.73,-244,51,126523,149958,67327507,512702,0.71,0.75,0.73,0.74,28
2021-06-07,23_2021,35,1273,4233698,5669,1.51,0.73,0.74,-68,65,126588,84567,67412074,572160,0.72,0.75,0.73,0.74,21
2021-06-08,23_2021,35,1896,4235592,5373,0.86,0.72,0.74,-296,102,126690,220917,67632991,583358,0.7,0.73,0.73,0.74,21
2021-06-09,23_2021,35,2199,4237790,5043,1.01,0.71,0.74,-330,77,126767,218738,67851729,595341,0.69,0.73,0.73,0.74,21
2021-06-10,23_2021,35,2079,4239868,4779,1.11,0.7,0.73,-264,88,126855,188120,68039849,634832,0.68,0.72,0.73,0.74,21
2021-06-11,23_2021,35,1901,4241760,4473,0.87,0.67,0.73,-306,69,126924,217610,68257459,623934,0.65,0.69,0.72,0.74,21
2021-06-12,23_2021,28,1723,4243482,4229,0.81,0.66,0.72,-244,52,126976,212966,68470425,567193,0.64,0.67,0.72,0.73,21
2021-06-13,23_2021,28,1390,4244872,4107,1.04,0.66,0.72,-122,26,127002,134136,68604561,436178,0.64,0.68,0.71,0.73,21
2021-06-14,24_2021,28,907,4245779,4001,1.15,0.65,0.72,-106,36,127038,78928,68683489,534362,0.63,0.67,0.71,0.72,14
2021-06-15,24_2021,28,1255,4247032,3837,0.59,0.65,0.71,-164,63,127101,212708,68896197,537307,0.63,0.67,0.71,0.72,14
2021-06-16,24_2021,28,1400,4248432,3535,0.69,0.64,0.71,-302,52,127153,203173,69099370,558808,0.62,0.66,0.7,0.72,14
2021-06-17,24_2021,28,1325,4249755,3332,0.66,0.63,0.71,-203,37,127190,200315,69299685,605784,0.61,0.65,0.7,0.71,14
2021-06-18,24_2021,28,1147,4250902,3096,0.53,0.63,0.7,-236,35,127225,216026,69515711,610401,0.61,0.65,0.69,0.71,14
2021-06-19,24_2021,22,1197,4252095,2898,0.48,0.63,0.7,-198,28,127253,249988,69765699,559855,0.61,0.66,0.69,0.71,14
2021-06-20,24_2021,22,881,4252976,2833,0.59,0.64,0.69,-65,17,127270,150522,69916221,438319,0.61,0.66,0.69,0.7,14
2021-06-21,25_2021,22,495,4253460,2775,0.61,0.62,0.69,-58,21,127291,81752,69997973,559537,0.6,0.65,0.68,0.7,9
2021-06-22,25_2021,22,835,4254294,2651,0.43,0.65,0.69,-124,31,127322,192882,70190855,572482,0.62,0.67,0.68,0.7,9
2021-06-23,25_2021,22,951,4255434,2484,0.48,0.66,0.69,-167,12,127334,198031,70388886,569244,0.63,0.68,0.68,0.7,9
2021-06-24,25_2021,22,927,4255700,2355,0.49,0.67,0.69,-129,28,127362,188191,70577077,612823,0.65,0.7,0.68,0.7,9
2021-06-25,25_2021,22,753,4256451,2205,0.39,0.7,0.69,-150,56,127418,192541,70769618,618254,0.67,0.73,0.68,0.7,9
2021-06-26,25_2021,21,838,4257289,2069,0.37,0.73,0.69,-136,40,127458,224493,70994111,555573,0.71,0.76,0.68,0.7,9
2021-06-27,25_2021,21,782,4258069,2037,0.57,0.78,0.69,-32,14,127472,137583,71131694,431823,0.75,0.81,0.68,0.7,9
2021-06-28,26_2021,21,389,4258456,2012,0.51,0.83,0.69,-25,28,127500,75861,71207555,560306,0.8,0.86,0.68,0.71,9
2021-06-29,26_2021,21,679,4259133,1946,0.36,0.88,0.7,-66,42,127542,190635,71398190,564261,0.85,0.92,0.69,0.71,9
2021-06-30,26_2021,21,776,4259909,1840,0.42,0.96,0.7,-106,24,127566,185016,71583206,574397,0.93,1,0.69,0.71,9
2021-07-01,26_2021,21,882,4260788,1761,0.47,1.07,0.71,-79,21,127587,188474,71771680,570074,1.03,1.11,0.69,0.72,9
2021-07-02,26_2021,21,794,4261582,1682,0.4,1.15,0.71,-79,28,127615,199238,71970918,556427,1.11,1.19,0.7,0.73,9
2021-07-03,26_2021,21,932,4262511,1598,0.41,1.23,0.72,-84,22,127637,228127,72199045,527711,1.19,1.27,0.71,0.73,9
2021-07-04,26_2021,21,808,4263317,1561,0.57,1.29,0.73,-37,12,127649,141640,72340685,414895,1.25,1.33,0.71,0.74,9
2021-07-05,27_2021,21,480,4263797,1528,0.64,1.36,0.73,-33,31,127680,74649,72415334,541495,1.32,1.4,0.72,0.74,14
2021-07-06,27_2021,21,907,4264704,1458,0.47,1.41,0.73,-70,24,127704,192424,72607758,539144,1.37,1.45,0.72,0.75,14
2021-07-07,27_2021,21,1010,4265714,1414,0.57,1.44,0.74,-44,14,127718,177977,72785735,549242,1.4,1.48,0.72,0.75,14
2021-07-08,27_2021,21,1394,4267105,1377,0.8,1.44,0.74,-37,13,127731,174852,72960587,586598,1.4,1.48,0.73,0.76,14
2021-07-09,27_2021,21,1390,4268491,1336,0.71,1.5,0.75,-41,25,127756,196922,73157509,599627,1.46,1.54,0.73,0.76,14
2021-07-10,27_2021,21,1400,4269885,1308,0.67,1.56,0.76,-28,12,127768,208419,73365928,569792,1.52,1.6,0.74,0.77,14
2021-07-11,27_2021,21,1391,4271276,1295,0.97,1.6,0.77,-13,7,127775,143332,73509260,411596,1.56,1.63,0.75,0.78,14
2021-07-12,28_2021,21,888,4272163,1307,1.21,1.68,0.78,12,13,127788,73571,73582831,567821,1.64,1.71,0.76,0.8,27
2021-07-13,28_2021,21,1534,4273693,1285,0.8,1.76,0.79,-22,20,127808,192543,73775374,572337,1.72,1.79,0.78,0.81,27
2021-07-14,28_2021,21,2153,4275846,1259,1.02,1.86,0.81,-26,23,127831,210599,73985973,568069,1.83,1.9,0.79,0.83,27
2021-07-15,28_2021,21,2455,4278319,1242,1.29,1.92,0.82,-17,9,127840,190922,74176895,614960,1.88,1.95,0.81,0.84,27
2021-07-16,28_2021,21,2898,4281214,1249,1.41,1.89,0.84,7,11,127851,205602,74382497,596867,1.86,1.92,0.82,0.86,27
2021-07-17,28_2021,21,3121,4284332,1273,1.27,1.83,0.86,24,13,127864,244797,74627294,538569,1.8,1.86,0.84,0.88,27
2021-07-18,28_2021,21,3127,4287458,1292,1.89,1.8,0.88,19,3,127867,165269,74792563,445302,1.78,1.83,0.86,0.9,27
2021-07-19,29_2021,21,2072,4289528,1350,2.33,1.75,0.91,58,7,127874,89089,74881652,575090,1.73,1.78,0.89,0.92,51
2021-07-20,29_2021,21,3558,4293083,1359,1.63,1.71,0.93,9,10,127884,218705,75100357,568022,1.69,1.74,0.91,0.95,51
2021-07-21,29_2021,21,4259,4297337,1354,1.81,1.64,0.95,-5,21,127905,235097,75335454,585001,1.61,1.66,0.93,0.97,51
2021-07-22,29_2021,21,5057,4302393,1392,2.3,1.55,0.98,38,15,127920,219778,75555232,607669,1.53,1.57,0.96,1,51
2021-07-23,29_2021,21,5143,4307535,1459,2.16,1.48,1.01,67,17,127937,237635,75792867,588328,1.46,1.5,0.99,1.03,51
2021-07-24,29_2021,21,5140,4312673,1512,1.99,1.42,1.04,53,5,127942,258929,76051796,495582,1.4,1.44,1.02,1.06,51
2021-07-25,29_2021,21,4743,4317415,1570,2.68,1.37,1.07,58,7,127949,176653,76228449,363831,1.35,1.39,1.05,1.09,51
2021-07-26,30_2021,21,3117,4320530,1694,3.53,1.35,1.1,124,22,127971,88247,76316696,565692,1.33,1.37,1.08,1.12,64
2021-07-27,30_2021,21,4522,4325046,1800,1.87,1.31,1.13,106,24,127995,241890,76558586,573984,1.3,1.33,1.11,1.16,64
2021-07-28,30_2021,21,5696,4330739,1868,2.29,1.28,1.17,68,15,128010,248472,76807058,539872,1.26,1.29,1.15,1.19,64
2021-07-29,30_2021,21,6171,4336906,1924,2.75,1.24,1.2,56,19,128029,224790,77031848,540419,1.22,1.25,1.18,1.23,64
2021-07-30,30_2021,21,6619,4343519,2013,2.67,1.21,1.23,89,18,128047,247486,77279334,516522,1.2,1.23,1.21,1.25,64
2021-07-31,30_2021,21,6513,4350028,2065,2.46,1.18,1.25,52,16,128063,264860,77544194,432909,1.16,1.19,1.23,1.27,64
2021-08-01,30_2021,21,5321,4355348,2184,3.17,1.16,1.27,119,2,128065,167761,77711955,296570,1.15,1.18,1.25,1.29,64
2021-08-02,31_2021,21,3190,4358533,2319,3.83,1.15,1.28,135,23,128088,83223,77795178,478077,1.13,1.16,1.26,1.3,70
2021-08-03,31_2021,21,4845,4363374,2454,2.31,1.13,1.29,135,27,128115,209719,78004897,469239,1.12,1.15,1.27,1.31,70
2021-08-04,31_2021,21,6596,4369964,2569,3.06,1.13,1.3,115,21,128136,215748,78220645,478483,1.11,1.14,1.28,1.32,70
2021-08-05,31_2021,21,7230,4377188,2677,3.41,1.12,1.31,108,27,128163,212227,78432872,462443,1.11,1.14,1.29,1.33,70
2021-08-06,31_2021,21,6599,4383787,2726,2.7,1.11,1.31,49,24,128187,244657,78677529,440358,1.1,1.13,1.29,1.33,70
2021-08-07,31_2021,21,6902,4390684,2821,2.35,1.11,1.31,95,22,128209,293863,78971392,345619,1.1,1.12,1.29,1.33,70
2021-08-08,31_2021,21,5735,4396417,2930,2.82,1.08,1.31,109,11,128220,203511,79174903,259777,1.07,1.1,1.29,1.33,70
2021-08-09,32_2021,21,4200,4400617,3109,4.08,1.07,1.31,179,22,128242,102864,79277767,407779,1.05,1.08,1.29,1.33,75
2021-08-10,32_2021,21,5636,4406241,3202,2.33,1.06,1.3,93,31,128273,241766,79519533,378036,1.05,1.08,1.29,1.32,75
2021-08-11,32_2021,21,6968,4413162,3285,3.03,1.04,1.29,83,31,128304,230039,79749572,359262,1.03,1.05,1.28,1.31,75
2021-08-12,32_2021,21,7270,4420429,3327,3.35,1.03,1.28,42,30,128334,216969,79966541,339252,1.02,1.04,1.26,1.3,75
2021-08-13,32_2021,21,7409,4427827,3402,3.29,1.02,1.27,75,45,128379,225486,80192027,297149,1.01,1.03,1.25,1.29,75
2021-08-14,32_2021,21,7188,4435008,3473,2.83,1.01,1.26,71,34,128413,254006,80446033,128846,1,1.03,1.24,1.27,75
2021-08-15,32_2021,21,5664,4440669,3546,3.52,1.01,1.24,73,19,128432,160870,80606903,52941,1,1.02,1.23,1.26,75
2021-08-16,33_2021,21,3674,4444338,3738,4.96,1.01,1.23,192,24,128456,74021,80680924,235239,1,1.03,1.22,1.25,75
2021-08-17,33_2021,21,5273,4449606,3895,2.21,1.01,1.22,157,54,128510,238073,80918997,251528,1,1.02,1.21,1.24,75
2021-08-18,33_2021,21,7162,4456765,4001,3.16,1.03,1.22,106,69,128579,226423,81145420,260088,1.02,1.04,1.2,1.23,75
2021-08-19,33_2021,21,7260,4464005,4087,3.52,1.03,1.22,86,55,128634,206531,81351951,242705,1.02,1.05,1.2,1.23,75
2021-08-20,33_2021,21,7224,4471225,4147,3.27,1.04,1.21,60,49,128683,220656,81572607,231836,1.03,1.05,1.2,1.23,75
2021-08-21,33_2021,21,7470,4478691,4199,2.93,1.04,1.21,52,45,128728,255218,81827825,156559,1.03,1.05,1.19,1.22,75
2021-08-22,33_2021,21,5923,4484613,4239,3.37,1.04,1.2,40,23,128751,175539,82003364,113390,1.03,1.05,1.19,1.22,75
2021-08-23,34_2021,21,4168,4488779,4413,4.11,1.03,1.19,174,44,128795,101341,82104705,311077,1.02,1.04,1.18,1.21,77
2021-08-24,34_2021,21,6076,4494857,4540,2.28,1,1.19,127,60,128855,266246,82370951,281270,0.99,1.02,1.17,1.2,77
2021-08-25,34_2021,21,7548,4502396,4522,3.09,0.98,1.18,-18,59,128914,244420,82615371,295524,0.97,0.99,1.16,1.19,77
2021-08-26,34_2021,21,7221,4509611,4562,3.27,0.96,1.16,40,43,128957,220872,82836243,282403,0.94,0.97,1.15,1.18,77
2021-08-27,34_2021,21,7826,4517434,4625,2.95,0.94,1.15,63,45,129002,265480,83101723,291132,0.93,0.95,1.14,1.17,77
2021-08-28,34_2021,22,6860,4524292,4622,2.34,0.93,1.14,-3,54,129056,293464,83395187,227616,0.91,0.94,1.13,1.15,77
2021-08-29,34_2021,22,5959,4530246,4658,2.67,0.91,1.13,36,37,129093,223086,83618273,161253,0.9,0.92,1.12,1.14,77
2021-08-30,35_2021,22,4257,4534499,4812,3.88,0.89,1.12,154,53,129146,109803,83728076,350885,0.88,0.9,1.11,1.13,70
2021-08-31,35_2021,22,5498,4539991,4796,1.79,0.88,1.11,-16,75,129221,307643,84035719,324497,0.87,0.89,1.1,1.12,70
2021-09-01,35_2021,22,6503,4546487,4771,2.14,0.89,1.1,-25,69,129290,303717,84339436,314484,0.88,0.9,1.09,1.11,70
2021-09-02,35_2021,22,6761,4553241,4760,2.31,0.89,1.09,-11,62,129352,293067,84632503,298974,0.88,0.9,1.08,1.1,70
2021-09-03,35_2021,22,6735,4559970,4720,2.27,0.9,1.08,-40,58,129410,296394,84928897,296535,0.88,0.91,1.06,1.09,70
2021-09-04,35_2021,22,6157,4566126,4773,1.86,0.9,1.07,53,56,129466,331350,85260247,221114,0.88,0.91,1.06,1.08,70
2021-09-05,35_2021,22,5315,4571440,4788,2.05,0.9,1.06,15,49,129515,259756,85520003,143386,0.89,0.91,1.05,1.07,70
2021-09-06,36_2021,22,3361,4574787,4872,2.5,0.89,1.05,84,52,129567,134393,85654396,290362,0.88,0.9,1.04,1.06,59
2021-09-07,36_2021,22,4720,4579502,4870,1.48,0.89,1.04,-2,71,129638,318865,85973261,283242,0.88,0.91,1.03,1.05,59
2021-09-08,36_2021,22,5923,4585423,4799,1.96,0.87,1.04,-71,69,129707,301980,86275241,271983,0.85,0.88,1.03,1.05,59
2021-09-09,36_2021,22,5522,4590941,4788,1.89,0.86,1.03,-11,59,129766,291468,86566709,278721,0.85,0.87,1.02,1.04,59
2021-09-10,36_2021,22,5621,4596558,4712,1.97,0.86,1.02,-76,62,129828,286028,86852737,274151,0.85,0.87,1.01,1.04,59
2021-09-11,36_2021,22,5193,4601749,4664,1.56,0.85,1.02,-48,57,129885,333741,87186478,205396,0.84,0.86,1.01,1.03,59
2021-09-12,36_2021,22,4664,4606413,4672,1.74,0.85,1.01,8,34,129919,267358,87453836,132418,0.84,0.86,1,1.02,59
2021-09-13,37_2021,22,2800,4609205,4763,2.33,0.85,1,91,36,129955,120045,87573881,256869,0.84,0.86,0.99,1.01,50
2021-09-14,37_2021,22,4021,4613214,4719,1.26,0.85,1,-44,72,130027,318593,87892474,239849,0.84,0.86,0.99,1.01,50
2021-09-15,37_2021,22,4830,4618040,4668,1.52,0.86,0.99,-51,73,130100,317666,88210140,224084,0.84,0.87,0.98,1,50
2021-09-16,37_2021,22,5117,4623155,4549,1.67,0.86,0.99,-119,67,130167,306267,88516407,216520,0.85,0.87,0.98,1,50
2021-09-17,37_2021,22,4552,4627699,4514,1.6,0.86,0.98,-35,66,130233,284579,88800986,218882,0.85,0.88,0.97,0.99,50
2021-09-18,37_2021,22,4578,4632275,4477,1.29,0.87,0.98,-37,51,130284,355933,89156919,207289,0.86,0.88,0.97,0.99,50
2021-09-19,37_2021,22,3838,4636111,4459,1.46,0.87,0.97,-18,26,130310,263571,89420490,131013,0.86,0.89,0.96,0.98,50
2021-09-20,38_2021,22,2407,4638516,4505,1.97,0.86,0.97,46,44,130354,122441,89542931,267029,0.85,0.88,0.96,0.98,41
2021-09-21,38_2021,22,3377,4641890,4453,1.02,0.85,0.96,-52,67,130421,330275,89873206,256473,0.84,0.87,0.95,0.97,41
2021-09-22,38_2021,22,3970,4645853,4309,1.36,0.85,0.96,-144,67,130488,292872,90166078,252231,0.83,0.86,0.95,0.97,41
2021-09-23,38_2021,22,4061,4649906,4155,1.3,0.85,0.95,-154,63,130551,311775,90477853,230326,0.84,0.86,0.94,0.96,41
2021-09-24,38_2021,22,3797,4653696,4042,1.32,0.85,0.94,-113,52,130603,287287,90765140,235576,0.84,0.87,0.93,0.95,41
2021-09-25,38_2021,22,3525,4657215,3978,0.99,0.85,0.93,-64,50,130653,357491,91122631,205250,0.84,0.87,0.92,0.94,41
2021-09-26,38_2021,22,3099,4660314,3918,1.12,0.86,0.92,-60,44,130697,276221,91398852,127564,0.85,0.88,0.91,0.94,41
2021-09-27,39_2021,22,1772,4662087,3975,1.43,0.88,0.92,57,45,130742,124077,91522929,222315,0.86,0.89,0.91,0.93,36
2021-09-28,39_2021,22,2985,4665049,3877,0.88,0.89,0.91,-98,65,130807,338425,91861354,202553,0.87,0.9,0.9,0.92,36
2021-09-29,39_2021,22,3212,4668261,3767,1.09,0.88,0.9,-110,63,130870,295452,92156806,197583,0.87,0.9,0.89,0.91,36
2021-09-30,39_2021,22,3804,4672355,3638,1.23,0.88,0.9,-129,51,130921,308836,92465642,204448,0.87,0.9,0.89,0.91,36
2021-10-01,39_2021,22,3405,4675758,3547,1.16,0.89,0.89,-91,52,130973,293469,92759111,176837,0.87,0.9,0.88,0.9,36
2021-10-02,39_2021,22,3312,4679067,3489,0.93,0.89,0.89,-58,25,130998,355896,93115007,150472,0.88,0.91,0.88,0.9,36
2021-10-03,39_2021,22,2968,4682034,3422,1.04,0.89,0.89,-67,33,131031,285960,93400967,86167,0.88,0.91,0.88,0.9,36
2021-10-04,40_2021,22,1612,4683646,3469,1.32,0.89,0.89,47,37,131068,122214,93523181,175532,0.87,0.9,0.87,0.9,31
2021-10-05,40_2021,22,2466,4686109,3401,0.77,0.89,0.88,-68,50,131118,322282,93845463,166337,0.87,0.91,0.87,0.89,31
2021-10-06,40_2021,22,3235,4689341,3287,1.07,0.89,0.88,-114,39,131157,301773,94147236,159419,0.88,0.91,0.87,0.89,31
2021-10-07,40_2021,22,2938,4692274,3227,0.99,0.89,0.88,-60,41,131198,297356,94444592,160994,0.87,0.91,0.87,0.89,31
2021-10-08,40_2021,21,3023,4695291,3125,1.11,0.88,0.88,-102,30,131228,271566,94716158,172836,0.86,0.9,0.87,0.89,31
2021-10-09,40_2021,21,2748,4698038,3059,0.8,0.88,0.88,-66,46,131274,344969,95061127,148478,0.86,0.9,0.87,0.89,31
2021-10-10,40_2021,21,2278,4700316,3015,0.84,0.91,0.88,-44,27,131301,270044,95331171,85331,0.89,0.93,0.87,0.89,31
2021-10-11,41_2021,21,1516,4701832,3062,1.32,0.92,0.88,47,34,131335,114776,95445947,183261,0.9,0.94,0.87,0.89,30
2021-10-12,41_2021,21,2494,4704318,3035,0.79,0.93,0.88,-27,49,131384,315285,95761232,189784,0.91,0.95,0.87,0.89,30
2021-10-13,41_2021,21,2772,4707087,2919,0.99,0.97,0.88,-116,37,131421,278945,96040177,205273,0.95,0.98,0.87,0.9,30
2021-10-14,41_2021,21,2668,4709753,2838,0.82,1.01,0.88,-81,40,131461,324614,96364791,225575,0.99,1.03,0.87,0.89,30
2021-10-15,41_2021,21,2732,4712482,2802,0.54,1.04,0.89,-36,42,131503,506043,96870834,219757,1.02,1.06,0.87,0.9,30
2021-10-16,41_2021,21,2983,4715464,2723,0.63,1.08,0.89,-79,14,131517,472535,97343369,171383,1.06,1.1,0.87,0.9,30
2021-10-17,41_2021,21,2437,4717899,2735,0.64,1.1,0.89,12,24,131541,381051,97724420,104057,1.08,1.12,0.88,0.9,30
2021-10-18,42_2021,21,1597,4719493,2786,0.73,1.16,0.89,51,44,131585,219878,97944298,197348,1.14,1.18,0.88,0.91,39
2021-10-19,42_2021,21,2697,4722188,2778,0.41,1.21,0.9,-8,70,131655,662000,98606298,186320,1.19,1.23,0.88,0.91,39
2021-10-20,42_2021,21,3702,4725887,2819,0.76,1.24,0.91,41,33,131688,485613,99091911,188162,1.22,1.26,0.89,0.92,39
2021-10-21,42_2021,21,3794,4729678,2795,0.66,1.27,0.92,-24,36,131724,574671,99666582,191918,1.25,1.29,0.91,0.93,39
2021-10-22,42_2021,21,3882,4733557,2786,0.8,1.3,0.93,-9,39,131763,487218,100153800,180701,1.28,1.32,0.92,0.94,39
2021-10-23,42_2021,21,3908,4737462,2793,0.79,1.31,0.95,7,39,131802,491574,100645374,133774,1.29,1.33,0.93,0.96,39
2021-10-24,42_2021,21,3725,4741185,2814,0.92,1.31,0.96,21,24,131826,403715,101049089,67644,1.29,1.33,0.95,0.97,39
2021-10-25,43_2021,21,2535,4743720,2917,1.14,1.3,0.97,103,30,131856,222385,101271474,170139,1.28,1.32,0.96,0.99,52
2021-10-26,43_2021,21,4054,4747773,2945,0.63,1.28,0.99,28,48,131904,639745,101911219,171587,1.26,1.3,0.97,1,52
2021-10-27,43_2021,21,4598,4752368,2956,0.98,1.26,1,11,50,131954,468104,102379323,183480,1.25,1.28,0.99,1.01,52
2021-10-28,43_2021,21,4866,4757231,2956,0.85,1.25,1.01,0,50,132004,570335,102949658,195828,1.23,1.26,1,1.02,52
2021-10-29,43_2021,21,5335,4762563,3007,1.12,1.21,1.02,51,33,132037,474778,103424436,183438,1.19,1.23,1.01,1.04,52
2021-10-30,43_2021,21,4878,4767440,3053,1.02,1.19,1.03,46,37,132074,477352,103901788,134311,1.18,1.21,1.02,1.05,52
2021-10-31,43_2021,21,4526,4771965,3096,1.29,1.17,1.04,43,26,132100,350170,104251958,60887,1.15,1.18,1.03,1.06,52
2021-11-01,44_2021,21,2818,4774783,3227,1.92,1.17,1.05,131,20,132120,146725,104398683,52687,1.15,1.19,1.04,1.07,61
2021-11-02,44_2021,21,2834,4777614,3377,1.19,1.21,1.07,150,41,132161,238354,104637037,168571,1.19,1.22,1.06,1.08,61
2021-11-03,44_2021,21,5188,4782802,3410,0.72,1.25,1.08,33,63,132224,717311,105354348,196283,1.23,1.26,1.07,1.1,61
2021-11-04,44_2021,21,5905,4788704,3428,1.15,1.27,1.1,18,59,132283,514629,105868977,203415,1.26,1.29,1.08,1.11,61
2021-11-05,44_2021,21,6764,4795465,3519,1.24,1.3,1.11,91,51,132334,543414,106412391,216397,1.29,1.32,1.09,1.12,61
2021-11-06,44_2021,21,6764,4802225,3565,1.37,1.29,1.12,46,31,132365,491962,106904353,153015,1.28,1.31,1.1,1.13,61
2021-11-07,44_2021,21,5822,4808047,3613,1.34,1.31,1.12,48,20,132385,434771,107339124,67223,1.3,1.33,1.11,1.14,61
2021-11-08,45_2021,21,4197,4812594,3777,1.68,1.32,1.13,164,38,132423,249115,107588239,201121,1.31,1.34,1.12,1.14,87
2021-11-09,45_2021,21,6032,4818705,3857,0.93,1.3,1.13,80,68,132491,645689,108233928,207413,1.29,1.32,1.12,1.15,87
2021-11-10,45_2021,21,7891,4826738,3870,1.62,1.27,1.13,13,60,132551,487618,108721546,217642,1.26,1.29,1.12,1.15,87
2021-11-11,45_2021,21,8569,4835435,3931,1.44,1.25,1.13,61,67,132618,595812,109317358,218943,1.24,1.27,1.12,1.15,87
2021-11-12,45_2021,21,8516,4843957,3970,1.71,1.23,1.13,39,68,132686,498935,109816293,223795,1.22,1.25,1.12,1.14,87
2021-11-13,45_2021,21,8544,4852496,4050,1.58,1.23,1.13,80,53,132739,540371,110356664,167232,1.22,1.25,1.12,1.14,87
2021-11-14,45_2021,21,7569,4860061,4105,1.7,1.23,1.13,55,36,132775,445593,110802257,74171,1.22,1.25,1.12,1.14,87
2021-11-15,46_2021,21,5144,4865260,4283,2.07,1.24,1.13,178,44,132819,248825,111051082,212307,1.23,1.25,1.12,1.14,111
2021-11-16,46_2021,21,7698,4873075,4451,1.12,1.25,1.13,168,74,132893,684710,111735792,219633,1.23,1.26,1.12,1.14,111
2021-11-17,46_2021,21,10172,4883242,4546,1.89,1.25,1.14,95,72,132965,537765,112273557,224624,1.23,1.26,1.12,1.15,111
2021-11-18,46_2021,21,10638,4893887,4591,1.7,1.25,1.14,45,69,133034,625774,112899331,244186,1.24,1.26,1.13,1.15,111
2021-11-19,46_2021,21,10544,4904441,4657,1.96,1.24,1.14,66,48,133082,538488,113437819,254651,1.23,1.25,1.13,1.16,111
2021-11-20,46_2021,21,11555,4915981,4762,2.01,1.24,1.15,105,49,133131,574812,114012631,194826,1.23,1.25,1.13,1.16,111
2021-11-21,46_2021,21,9709,4925688,4865,1.99,1.22,1.15,103,46,133177,487109,114499740,83910,1.21,1.23,1.14,1.16,111
2021-11-22,47_2021,21,6404,4932091,5056,2.39,1.22,1.15,191,70,133247,267570,114767310,256241,1.21,1.23,1.14,1.17,139
2021-11-23,47_2021,21,10047,4942135,5157,1.46,1.21,1.15,101,83,133330,689280,115456590,285889,1.2,1.22,1.14,1.17,139
2021-11-24,47_2021,21,12448,4954585,5202,2.21,1.2,1.15,45,85,133415,562505,116019095,319699,1.19,1.21,1.14,1.16,139
2021-11-25,47_2021,21,13764,4968341,5277,2.12,1.19,1.15,75,71,133486,649998,116669093,350969,1.18,1.2,1.14,1.16,139
2021-11-26,47_2021,21,13686,4982022,5354,2.46,1.18,1.15,77,51,133537,557180,117226273,370765,1.17,1.19,1.13,1.16,139
2021-11-27,47_2021,22,12877,4994891,5450,2.16,1.17,1.14,96,90,133627,596898,117823171,315526,1.16,1.18,1.13,1.16,139
2021-11-28,47_2021,22,12932,5007818,5602,2.52,1.16,1.14,152,47,133674,512592,118335763,161454,1.15,1.17,1.13,1.15,139
2021-11-29,48_2021,22,7975,5015790,5804,2.89,1.15,1.14,202,65,133739,276000,118611763,380229,1.14,1.16,1.13,1.15,172
2021-11-30,48_2021,22,12764,5028547,5910,1.77,1.14,1.14,106,89,133828,719972,119331735,419879,1.13,1.15,1.13,1.15,172
2021-12-01,48_2021,22,15085,5043620,5934,2.63,1.17,1.14,24,103,133931,573775,119905510,465257,1.16,1.18,1.13,1.15,172
2021-12-02,48_2021,22,16806,5060430,5996,2.47,1.16,1.14,62,72,134003,679462,120584972,495266,1.15,1.17,1.13,1.15,172
2021-12-03,48_2021,22,17030,5077445,6093,2.89,1.16,1.14,97,74,134077,588445,121173417,524950,1.15,1.17,1.12,1.15,172
2021-12-04,48_2021,23,16632,5094072,6160,2.61,1.16,1.13,67,75,134152,636592,121810009,471066,1.15,1.17,1.12,1.14,172
2021-12-05,48_2021,23,15021,5109082,6333,2.86,1.15,1.13,173,43,134195,525108,122335117,294729,1.14,1.16,1.12,1.14,172
2021-12-06,49_2021,23,9503,5118576,6622,3.15,1.15,1.13,289,92,134287,301560,122636677,524563,1.15,1.16,1.12,1.14,198
2021-12-07,49_2021,23,15756,5134318,6854,2.27,1.16,1.13,232,99,134386,695136,123331813,543911,1.15,1.17,1.12,1.14,198
2021-12-08,49_2021,23,17959,5152264,6890,3.18,1.14,1.14,36,86,134472,564698,123896511,281539,1.13,1.15,1.13,1.15,198
2021-12-09,49_2021,23,12527,5164780,7144,4,1.15,1.14,254,79,134551,312828,124209339,558439,1.14,1.16,1.13,1.15,198
2021-12-10,49_2021,23,20497,5185270,7299,2.86,1.17,1.15,155,118,134669,716287,124925626,578857,1.16,1.18,1.14,1.16,198
2021-12-11,49_2021,24,21042,5206305,7357,3.72,1.18,1.15,58,96,134765,565077,125490703,511800,1.17,1.19,1.14,1.16,198
2021-12-12,49_2021,24,19215,5225517,7526,3.83,1.2,1.16,169,66,134831,501815,125992518,325154,1.19,1.21,1.15,1.17,198
2021-12-13,50_2021,24,12712,5238221,7807,4.05,1.22,1.16,281,98,134929,313536,126306054,523391,1.21,1.23,1.15,1.17,277
2021-12-14,50_2021,24,20677,5258886,8026,2.66,1.24,1.16,219,120,135049,776563,127082617,548951,1.23,1.25,1.15,1.17,277
2021-12-15,50_2021,24,23195,5282076,8179,3.65,1.25,1.16,153,129,135178,634638,127717255,570415,1.24,1.26,1.15,1.17,277
2021-12-16,50_2021,24,26109,5308180,8255,3.63,1.24,1.16,76,123,135301,718281,128435536,590210,1.23,1.25,1.15,1.17,277
2021-12-17,50_2021,24,28632,5336795,8443,4.28,1.24,1.16,188,120,135421,669160,129104696,584237,1.23,1.25,1.15,1.17,277
2021-12-18,50_2021,28,28064,5364852,8529,4.02,1.25,1.16,86,123,135544,697740,129802436,544976,1.24,1.25,1.15,1.16,277
2021-12-19,50_2021,28,24259,5389155,8692,4.28,1.27,1.15,163,97,135641,566300,130368736,350731,1.26,1.27,1.14,1.16,277
2021-12-20,51_2021,28,16213,5405360,9088,4.81,1.34,1.15,396,137,135778,337222,130705958,546232,1.33,1.34,1.14,1.16,438
2021-12-21,51_2021,28,30798,5436143,9393,3.62,1.4,1.15,305,153,135931,851865,131557823,561356,1.39,1.41,1.14,1.16,438
2021-12-22,51_2021,28,36293,5472469,9554,4.66,1.46,1.15,161,146,136077,779303,132337126,552777,1.45,1.47,1.14,1.16,438
2021-12-23,51_2021,28,44595,5517054,9745,4.95,1.52,1.16,191,168,136245,901450,133238576,494397,1.51,1.53,1.15,1.17,438
2021-12-24,51_2021,28,50599,5567644,9850,5.44,1.58,1.16,105,141,136386,929775,134168351,237777,1.57,1.58,1.15,1.16,438
2021-12-25,51_2021,28,54762,5622431,9963,5.65,1.61,1.16,113,144,136530,969752,135138103,36651,1.6,1.62,1.15,1.16,438
2021-12-26,51_2021,28,24883,5647313,10309,11.46,1.71,1.16,346,81,136611,217052,135355155,183547,1.7,1.71,1.15,1.17,438
2021-12-27,52_2021,28,30810,5678112,10849,8.96,1.84,1.16,540,142,136753,343968,135699123,597094,1.83,1.85,1.15,1.17,1154
2021-12-28,52_2021,28,78313,5756412,11234,7.57,1.9,1.17,385,190,136943,1034677,136733800,651516,1.89,1.91,1.16,1.17,1154
2021-12-29,52_2021,28,98030,5854428,11763,9.52,1.87,1.17,529,148,137091,1029429,137763229,640892,1.86,1.88,1.17,1.18,1154
2021-12-30,52_2021,28,126888,5981428,12092,11.03,1.77,1.18,329,156,137247,1150352,138913581,582724,1.77,1.78,1.17,1.19,1154
2021-12-31,52_2021,32,144243,6125683,12410,11.78,1.64,1.19,318,155,137402,1224025,140137606,280978,1.63,1.64,1.18,1.2,1154
2022-01-01,52_2021,32,141358,6267035,12562,12.5,1.57,1.2,152,111,137513,1130936,141268542,73161,1.56,1.57,1.19,1.21,1155
2022-01-02,52_2021,32,61046,6328076,13075,21.91,1.47,1.21,513,133,137646,278654,141547196,339332,1.46,1.47,1.2,1.22,1155
2022-01-03,1_2022,32,68052,6396110,13684,15.28,1.41,1.21,609,140,137786,445321,141992517,628471,1.41,1.42,1.21,1.22,1881
2022-01-04,1_2022,32,170844,6566947,14304,13.91,1.32,1.22,620,259,138045,1228410,143220927,689602,1.31,1.32,1.21,1.23,1881
2022-01-05,1_2022,32,189109,6756035,14792,17.28,1.25,1.22,488,231,138276,1094255,144315182,667694,1.24,1.25,1.22,1.23,1881
2022-01-06,1_2022,32,219441,6975465,15294,19.28,1.18,1.23,502,198,138474,1138310,145453492,340600,1.18,1.19,1.22,1.24,1881
2022-01-07,1_2022,32,108304,7083762,16090,22.01,1.18,1.23,796,223,138697,492172,145945664,688610,1.17,1.18,1.23,1.24,1881
2022-01-08,1_2022,36,197552,7281297,16487,16.19,1.13,1.24,397,184,138881,1220266,147165930,641024,1.12,1.13,1.24,1.25,1881
2022-01-09,1_2022,36,155659,7436939,17242,15.67,1.08,1.25,755,157,139038,993201,148159131,421247,1.08,1.09,1.24,1.26,1881
2022-01-10,2_2022,36,101762,7554344,17946,16.61,1.03,1.26,704,227,139265,612821,148771952,669225,1.02,1.03,1.25,1.26,2068
2022-01-11,2_2022,36,220532,7774863,18744,16.03,1,1.26,798,294,139559,1375514,150147466,725840,0.99,1,1.25,1.27,2068
2022-01-12,2_2022,36,196224,7971068,18978,16.48,0.98,1.26,234,313,139872,1190567,151338033,714169,0.98,0.99,1.25,1.27,2068
2022-01-13,2_2022,36,184615,8155645,19316,15.63,1,1.26,338,316,140188,1181179,152519212,708547,0.99,1,1.25,1.26,2068
2022-01-14,2_2022,36,186253,8356514,19698,16.45,0.99,1.25,382,360,140548,1132309,153651521,708394,0.98,0.99,1.24,1.25,2068
2022-01-15,2_2022,38,180426,8549450,20047,14.82,0.99,1.24,349,308,140856,1217830,154869351,700379,0.98,0.99,1.23,1.24,2068
2022-01-16,2_2022,38,149512,8706915,20410,16.11,0.99,1.22,363,248,141104,927846,155797197,434173,0.99,0.99,1.22,1.23,2068
2022-01-17,3_2022,38,83403,8790302,20945,15.41,0.99,1.21,535,287,141391,541298,156338495,599723,0.99,1,1.2,1.22,1977
2022-01-18,3_2022,38,212004,9018425,21163,14.31,1,1.19,218,434,141825,1481349,157819844,631281,0.99,1,1.19,1.2,1977
2022-01-19,3_2022,38,192320,9219391,21188,16.27,1,1.18,25,380,142205,1181889,159001733,611514,0.99,1,1.17,1.18,1977
2022-01-20,3_2022,38,188797,9418256,21357,17,1,1.16,169,385,142590,1110266,160111999,604276,0.99,1,1.16,1.17,1977
2022-01-21,3_2022,44,179106,9603856,21192,16.03,0.99,1.15,-165,373,142963,1117553,161229552,587159,0.99,0.99,1.14,1.15,1977
2022-01-22,3_2022,44,171263,9781191,21118,16.41,0.97,1.13,-74,333,143296,1043649,162273201,565962,0.97,0.98,1.12,1.13,1977
2022-01-23,3_2022,44,138860,9923678,21312,14.88,0.95,1.11,194,227,143523,933384,163206585,348249,0.95,0.95,1.11,1.12,1977
2022-01-24,4_2022,44,77696,10001344,21547,14.96,0.93,1.1,235,352,143875,519293,163725878,531718,0.92,0.93,1.09,1.1,1656
2022-01-25,4_2022,44,190514,10216395,21728,13.4,0.9,1.08,181,469,144344,1421545,165147423,552606,0.89,0.9,1.08,1.09,1656
2022-01-26,4_2022,44,167206,10383561,21666,15.24,0.88,1.07,-62,426,144770,1097287,166244710,531904,0.87,0.88,1.06,1.08,1656
2022-01-27,4_2022,44,155697,10539601,21498,14.97,0.85,1.06,-168,389,145159,1039756,167284466,519192,0.85,0.85,1.05,1.06,1656
2022-01-28,4_2022,44,143898,10683948,21426,13.69,0.84,1.05,-72,378,145537,1051288,168335754,533569,0.83,0.84,1.04,1.05,1656
2022-01-29,4_2022,44,137147,10821375,21224,13.72,0.82,1.04,-202,377,145914,999490,169335244,528297,0.82,0.82,1.03,1.05,1656
2022-01-30,4_2022,44,104065,10925485,21210,12.72,0.81,1.03,-14,235,146149,818169,170153413,320436,0.8,0.81,1.03,1.04,1656
2022-01-31,5_2022,44,57715,10983116,21497,12.07,0.78,1.03,287,349,146498,478314,170631727,452234,0.78,0.78,1.02,1.03,1178
2022-02-01,5_2022,44,133142,11116422,21422,10.68,0.77,1.02,-75,427,146925,1246987,171878714,425965,0.77,0.78,1.01,1.02,1178
2022-02-02,5_2022,44,118994,11235745,21074,12.34,0.77,1.01,-348,395,147320,964521,172843235,388736,0.76,0.77,1,1.02,1178
2022-02-03,5_2022,44,112691,11348701,20781,12.31,0.76,1,-293,414,147734,915337,173758572,361598,0.76,0.77,1,1.01,1178
2022-02-04,5_2022,44,99522,11449601,20440,11.25,0.75,0.99,-341,433,148167,884893,174643465,368476,0.75,0.76,0.99,1,1178
2022-02-05,5_2022,45,93157,11542793,20026,11.01,0.75,0.99,-414,375,148542,846480,175489945,365552,0.75,0.76,0.98,0.99,1178
2022-02-06,5_2022,45,78952,11621736,19929,11.5,0.76,0.98,-97,229,148771,686544,176176489,190631,0.75,0.76,0.97,0.98,1178
2022-02-07,6_2022,45,41247,11663338,20098,10.48,0.74,0.97,169,326,149097,393663,176570152,284919,0.74,0.75,0.97,0.98,817
2022-02-08,6_2022,45,101864,11765767,19713,10.2,0.72,0.96,-385,415,149512,999095,177569247,273774,0.72,0.73,0.96,0.97,817
2022-02-09,6_2022,45,81367,11847436,19282,11.13,0.71,0.95,-431,384,149896,731284,178300531,243690,0.7,0.71,0.95,0.96,817
2022-02-10,6_2022,45,75861,11923631,18676,11.1,0.7,0.94,-606,325,150221,683715,178984246,239081,0.7,0.71,0.94,0.95,817
2022-02-11,6_2022,45,67152,11991109,18089,10.12,0.7,0.93,-587,334,150555,663786,179648032,242161,0.7,0.71,0.93,0.94,817
2022-02-12,6_2022,44,62231,12053330,17533,10.59,0.7,0.93,-556,269,150824,587645,180235677,242982,0.7,0.71,0.92,0.93,817
2022-02-13,6_2022,44,51959,12105675,17250,11.23,0.71,0.92,-283,191,151015,462881,180698558,119414,0.71,0.72,0.91,0.92,817
2022-02-14,7_2022,44,28630,12134451,17223,10.08,0.71,0.91,-27,281,151296,283891,180982449,173414,0.71,0.72,0.9,0.91,617
2022-02-15,7_2022,44,70852,12205474,16721,10.18,0.72,0.9,-502,388,151684,695744,181678193,184113,0.72,0.73,0.89,0.9,617
2022-02-16,7_2022,44,59749,12265343,16200,10.76,0.74,0.89,-521,278,151962,555080,182233273,161905,0.73,0.74,0.88,0.89,617
2022-02-17,7_2022,44,57890,12323398,15599,10.76,0.76,0.88,-601,320,152282,538131,182771404,149869,0.75,0.76,0.87,0.88,617
2022-02-18,7_2022,44,53662,12377098,14935,10.52,0.77,0.87,-664,314,152596,510283,183281687,168674,0.77,0.78,0.86,0.87,617
2022-02-19,7_2022,41,50534,12427773,14340,10.27,0.8,0.86,-595,252,152848,492045,183773732,162235,0.79,0.8,0.85,0.86,617
2022-02-20,7_2022,41,42081,12469975,14218,11.29,0.82,0.85,-122,141,152989,372776,184146508,75477,0.82,0.83,0.85,0.86,617
2022-02-21,8_2022,41,24408,12494459,14303,10.53,0.83,0.85,85,201,153190,231766,184378274,133706,0.83,0.84,0.84,0.85,491
2022-02-22,8_2022,41,60029,12554596,13972,9.94,0.85,0.84,-331,322,153512,603639,184981913,127294,0.84,0.85,0.84,0.85,491
2022-02-23,8_2022,41,49040,12603758,13413,10.23,0.86,0.84,-559,252,153764,479447,185461360,118785,0.85,0.86,0.84,0.85,491
2022-02-24,8_2022,41,46169,12651251,12964,9.53,0.85,0.84,-449,249,154013,484530,185945890,116692,0.85,0.86,0.83,0.84,491
2022-02-25,8_2022,41,40948,12693320,12505,9.3,0.85,0.84,-459,193,154206,440115,186386005,130999,0.84,0.86,0.83,0.84,491
2022-02-26,8_2022,36,38375,12732680,11866,8.84,0.85,0.84,-639,210,154416,434077,186820082,133560,0.84,0.85,0.83,0.84,491
2022-02-27,8_2022,36,30629,12764558,11601,9.64,0.84,0.83,-265,144,154560,317784,187137866,60544,0.83,0.85,0.83,0.84,491
2022-02-28,9_2022,36,17981,12782836,11565,9.06,0.83,0.83,-36,207,154767,198513,187336379,115451,0.83,0.84,0.82,0.83,434
2022-03-01,9_2022,36,46631,12829972,11164,8.78,0.85,0.82,-401,233,155000,530858,187867237,84809,0.84,0.85,0.82,0.83,434
2022-03-02,9_2022,36,36429,12867918,10635,8.77,0.87,0.82,-529,214,155214,415288,188282525,79674,0.86,0.87,0.81,0.82,434
2022-03-03,9_2022,36,41500,12910506,10253,9.62,0.9,0.81,-382,185,155399,431312,188713837,85822,0.9,0.91,0.81,0.82,434
2022-03-04,9_2022,36,38095,12948859,9922,9.8,0.95,0.81,-331,210,155609,388836,189102673,93426,0.94,0.95,0.8,0.81,434
2022-03-05,9_2022,33,39963,12990223,9583,10.48,1,0.81,-339,173,155782,381484,189484157,88517,0.99,1,0.8,0.81,434
2022-03-06,9_2022,33,35057,13026112,9431,11.83,1.04,0.81,-152,105,155887,296246,189780403,29288,1.03,1.05,0.8,0.81,434
2022-03-07,10_2022,33,22083,13048774,9599,11.73,1.09,0.81,168,130,156017,188274,189968677,73980,1.08,1.1,0.8,0.82,579
2022-03-08,10_2022,33,60191,13109527,9368,11.33,1.12,0.81,-231,184,156201,531194,190499871,70972,1.12,1.13,0.81,0.82,579
2022-03-09,10_2022,33,48483,13159342,9138,11.17,1.15,0.82,-230,156,156357,433961,190933832,66274,1.14,1.16,0.81,0.82,579
2022-03-10,10_2022,33,54230,13214498,8959,11.96,1.17,0.83,-179,136,156493,453341,191387173,72738,1.17,1.18,0.82,0.83,579
2022-03-11,10_2022,33,53127,13268459,8801,12.48,1.19,0.84,-158,156,156649,425638,191812811,79451,1.19,1.2,0.83,0.84,579
2022-03-12,10_2022,25,53825,13323128,8747,12.88,1.21,0.85,-54,133,156782,417777,192230588,77780,1.21,1.22,0.84,0.85,579
2022-03-13,10_2022,25,48886,13373207,8756,14.81,1.23,0.86,9,86,156868,330028,192560616,24183,1.23,1.24,0.85,0.87,579
2022-03-14,11_2022,25,28900,13402905,8986,14.11,1.27,0.87,230,129,156997,204877,192765493,62344,1.27,1.28,0.86,0.88,810
2022-03-15,11_2022,25,85288,13489319,8975,14.53,1.29,0.89,-11,180,157177,587015,193352508,63384,1.29,1.3,0.88,0.89,810
2022-03-16,11_2022,25,72568,13563466,8887,14.79,1.31,0.9,-88,137,157314,490711,193843219,56799,1.3,1.32,0.89,0.91,810
2022-03-17,11_2022,25,79895,13645834,8870,15.08,1.3,0.91,-17,128,157442,529882,194373101,60057,1.29,1.3,0.91,0.92,810
2022-03-18,11_2022,25,76250,13724411,8877,15.53,1.27,0.93,7,165,157607,490883,194863984,64538,1.26,1.28,0.92,0.94,810
2022-03-19,11_2022,22,74024,13800179,8790,15.48,1.23,0.94,-87,85,157692,478051,195342035,60372,1.22,1.23,0.94,0.95,810
2022-03-20,11_2022,22,60415,13861743,8897,16.31,1.19,0.96,107,93,157785,370466,195712501,15248,1.18,1.2,0.95,0.96,810
2022-03-21,12_2022,22,32573,13895188,9191,14.93,1.16,0.97,294,119,157904,218216,195930717,52146,1.15,1.16,0.96,0.98,841
2022-03-22,12_2022,22,96365,13992092,9424,15.01,1.12,0.98,233,197,158101,641896,196572613,50402,1.12,1.13,0.97,0.99,841
2022-03-23,12_2022,22,76260,14070450,9405,14.84,1.09,0.99,-19,153,158254,513744,197086357,44718,1.08,1.09,0.99,1,841
2022-03-24,12_2022,22,81811,14153098,9476,15,1.06,1.01,71,182,158436,545302,197631659,51501,1.06,1.07,1,1.02,841
2022-03-25,12_2022,22,75616,14229495,9441,15,1.05,1.02,-35,146,158582,503973,198135632,55985,1.04,1.05,1.01,1.03,841
2022-03-26,12_2022,21,73357,14304111,9475,14.55,1.03,1.03,34,118,158700,504185,198639817,53234,1.03,1.04,1.02,1.04,841
2022-03-27,12_2022,21,59555,14364723,9645,15.5,1.02,1.04,170,82,158782,384323,199024140,12959,1.02,1.03,1.03,1.04,841
2022-03-28,13_2022,21,30710,14396283,9983,14.52,1.02,1.05,338,95,158877,211535,199235675,44547,1.01,1.02,1.04,1.05,814
2022-03-29,13_2022,21,99457,14496579,10227,15.05,1.01,1.05,244,177,159054,660708,199896383,41806,1,1.02,1.04,1.06,814
2022-03-30,13_2022,21,77621,14567990,10352,14.79,1,1.06,125,170,159224,524899,200421282,38633,1,1.01,1.05,1.07,814
2022-03-31,13_2022,21,73195,14642354,10366,15.04,0.98,1.07,14,159,159383,486813,200908095,42358,0.98,0.99,1.06,1.07,814
2022-04-01,13_2022,0,74350,14719394,10457,14.44,0.98,1.07,91,154,159537,514823,201422918,31739,0.98,0.99,1.06,1.08,814
2022-04-02,13_2022,0,70803,14790806,10442,14.84,0.97,1.08,-15,129,159666,477041,201899959,29602,0.97,0.98,1.07,1.08,814
2022-04-03,13_2022,0,53588,14845815,10506,14.71,0.96,1.08,64,118,159784,364182,202264141,5947,0.95,0.96,1.07,1.09,814
2022-04-04,14_2022,0,30630,14877144,10724,2.21,0.94,1.08,218,125,159909,1383218,203647359,27057,0.93,0.94,1.07,1.09,746
2022-04-05,14_2022,0,88173,14966058,10717,14.98,0.93,1.07,-7,194,160103,588576,204235935,28996,0.92,0.93,1.07,1.08,746
2022-04-06,14_2022,0,69278,15035943,10630,15.01,0.93,1.07,-87,149,160252,461448,204697383,28134,0.92,0.93,1.06,1.07,746
2022-04-07,14_2022,0,69596,15106066,10549,14.81,0.93,1.06,-81,150,160402,469803,205167186,29508,0.93,0.94,1.05,1.07,746
2022-04-08,14_2022,0,66535,15173707,10564,15.05,0.93,1.05,15,144,160546,442029,205609215,33640,0.93,0.94,1.04,1.06,746
2022-04-09,14_2022,0,63992,15238128,10485,14.6,0.94,1.04,-79,112,160658,438449,206047664,30065,0.93,0.94,1.03,1.05,746
2022-04-10,14_2022,0,51376,15292048,10503,14.58,0.94,1.03,18,90,160748,352265,206399929,5862,0.94,0.95,1.03,1.04,746
2022-04-11,15_2022,0,28368,15320753,10722,14.72,0.94,1.03,219,115,160863,192782,206592711,28520,0.93,0.94,1.02,1.03,707
2022-04-12,15_2022,0,83643,15404809,10670,14.86,0.93,1.02,-52,169,161032,563018,207155729,27788,0.93,0.94,1.01,1.03,707
2022-04-13,15_2022,0,62037,15467395,10615,14.77,0.93,1.02,-55,155,161187,419995,207575724,29122,0.92,0.93,1.01,1.02,707
2022-04-14,15_2022,0,64951,15533012,10495,14.82,0.92,1.01,-120,149,161336,438375,208014099,35998,0.92,0.93,1.01,1.02,707
2022-04-15,15_2022,0,61555,15595302,10399,15.49,0.92,1.01,-96,133,161469,397482,208411581,32313,0.91,0.92,1,1.02,707
2022-04-16,15_2022,0,63815,15659835,10289,15.03,0.91,1,-110,133,161602,424482,208836063,18932,0.9,0.91,1,1.01,707
2022-04-17,15_2022,0,51993,15712088,10161,15.56,0.89,1,-128,85,161687,334224,209170287,514,0.89,0.9,0.99,1,707
2022-04-18,16_2022,0,18380,15730676,10351,17.38,0.86,0.99,190,79,161766,105739,209276026,1913,0.86,0.87,0.98,1,714
2022-04-19,16_2022,0,27214,15758002,10636,15.63,0.92,0.99,285,127,161893,174098,209450124,42160,0.91,0.93,0.98,1,714
2022-04-20,16_2022,0,99848,15858442,10620,16.35,0.96,0.99,-16,205,162098,610600,210060724,45017,0.95,0.96,0.99,1,714
2022-04-21,16_2022,0,75020,15934437,10646,16.81,0.99,1,26,166,162264,446180,210506904,45245,0.98,0.99,0.99,1,714
2022-04-22,16_2022,0,73212,16008181,10487,16.75,1.01,1,-159,202,162466,437193,210944097,48339,1,1.01,0.99,1,714
2022-04-23,16_2022,0,70520,16079209,10323,16.73,1.01,1,-164,143,162609,421533,211365630,37792,1,1.02,0.99,1.01,714
2022-04-24,16_2022,0,56263,16136057,10311,17.25,1.01,1,-12,79,162688,326211,211691841,6829,1.01,1.02,0.99,1.01,714
2022-04-25,17_2022,0,24878,16161339,10466,17.92,1,1,155,93,162781,138803,211830644,3444,1,1.01,1,1.01,619
2022-04-26,17_2022,0,29575,16191323,10737,16.19,0.98,1,271,146,162927,182675,212013319,49500,0.98,0.99,1,1.01,619
2022-04-27,17_2022,0,87940,16279754,10549,15.86,0.95,1,-188,186,163113,554526,212567845,49193,0.95,0.96,1,1.01,619
2022-04-28,17_2022,0,69204,16349788,10458,15.67,0.93,1,-91,131,163244,441526,213009371,46134,0.92,0.93,0.99,1.01,619
2022-04-29,17_2022,0,58861,16409183,10313,15.44,0.91,1,-145,133,163377,381239,213390610,47276,0.9,0.91,0.99,1,619
2022-04-30,17_2022,0,53602,16463200,10192,13.99,0.9,1,-121,130,163507,383073,213773683,35871,0.89,0.9,0.99,1,619
2022-05-01,17_2022,0,40757,16504791,10104,14.17,0.91,0.99,-88,105,163612,287601,214061284,2369,0.9,0.92,0.99,1,619
2022-05-02,18_2022,0,18896,16523859,10162,15.43,0.94,0.99,58,124,163736,122444,214183728,34786,0.93,0.94,0.98,1,495
2022-05-03,18_2022,0,62071,16586268,10061,15.1,0.88,0.98,-101,153,163889,411047,214594775,42933,0.87,0.88,0.97,0.99,495
2022-05-04,18_2022,0,47039,16633911,9985,14.03,0.86,0.98,-76,152,164041,335275,214930050,44658,0.85,0.86,0.97,0.98,495
2022-05-05,18_2022,0,48255,16682626,9753,14.75,0.85,0.97,-232,138,164179,327178,215257228,43997,0.84,0.85,0.96,0.98,495
2022-05-06,18_2022,0,43947,16726990,9527,14.53,0.84,0.96,-226,125,164304,302406,215559634,42780,0.84,0.85,0.95,0.97,495
2022-05-07,18_2022,0,40522,16767773,9170,13.26,0.85,0.95,-357,113,164417,305563,215865197,29577,0.84,0.86,0.94,0.96,495
2022-05-08,18_2022,0,30804,16798998,9011,15.14,0.85,0.94,-159,72,164489,203454,216068651,5649,0.85,0.86,0.93,0.95,495
2022-05-09,19_2022,0,17155,16816419,9098,13.55,0.85,0.93,87,84,164573,126559,216195210,34235,0.85,0.86,0.93,0.94,435
2022-05-10,19_2022,0,56015,16872618,8937,15.09,0.87,0.93,-161,158,164731,371221,216566431,41201,0.86,0.87,0.92,0.93,435
2022-05-11,19_2022,0,42249,16915301,8750,14.34,0.87,0.92,-187,115,164846,294611,216861042,45095,0.86,0.87,0.91,0.92,435
2022-05-12,19_2022,0,39317,16954784,8492,14.63,0.87,0.91,-258,130,164976,268654,217129696,44136,0.86,0.88,0.9,0.92,435
2022-05-13,19_2022,0,38507,16993813,8248,14.5,0.87,0.9,-244,115,165091,265647,217395343,41289,0.86,0.87,0.89,0.91,435
2022-05-14,19_2022,0,36042,17030147,7990,13.67,0.86,0.9,-258,91,165182,263747,217659090,29748,0.86,0.87,0.89,0.9,435
2022-05-15,19_2022,0,27162,17057873,7879,13.96,0.85,0.89,-111,62,165244,194577,217853667,5691,0.85,0.86,0.89,0.9,435
2022-05-16,20_2022,0,13668,17071649,7984,13.04,0.83,0.89,105,102,165346,104793,217958460,30188,0.83,0.84,0.88,0.9,318
2022-05-17,20_2022,0,44489,17116550,7802,13.27,0.81,0.89,-182,148,165494,335217,218293677,34975,0.8,0.81,0.88,0.89,318
2022-05-18,20_2022,0,30408,17147477,7594,11.51,0.78,0.88,-208,136,165630,264273,218557950,40614,0.78,0.79,0.88,0.89,318
2022-05-19,20_2022,0,30310,17178199,7328,12.25,0.76,0.88,-266,108,165738,247471,218805421,39048,0.76,0.77,0.87,0.89,318
2022-05-20,20_2022,0,26561,17205017,7119,11.36,0.75,0.88,-209,89,165827,233745,219039166,34431,0.74,0.76,0.87,0.88,318
2022-05-21,20_2022,0,23976,17229263,6871,10.34,0.74,0.87,-248,91,165918,231931,219271097,25484,0.74,0.75,0.87,0.88,318
2022-05-22,20_2022,0,17744,17247552,6692,11.02,0.74,0.87,-179,34,165952,160995,219432092,4631,0.74,0.75,0.86,0.88,318
2022-05-23,21_2022,0,9820,17257573,6679,10.47,0.72,0.86,-13,80,166032,93813,219525905,27046,0.72,0.73,0.86,0.87,234
2022-05-24,21_2022,0,31024,17289433,6526,10.74,0.71,0.86,-153,118,166150,288863,219814768,33058,0.71,0.72,0.85,0.87,234
2022-05-25,21_2022,0,22438,17312432,6240,10.19,0.7,0.85,-286,114,166264,220101,220034869,35935,0.7,0.71,0.85,0.86,234
2022-05-26,21_2022,0,22093,17335068,5995,10.18,0.7,0.85,-245,107,166371,216988,220251857,35313,0.7,0.71,0.84,0.86,234
2022-05-27,21_2022,0,19666,17355119,5810,9.89,0.69,0.84,-185,105,166476,198897,220450754,32118,0.69,0.7,0.83,0.85,234
2022-05-28,21_2022,0,18255,17373741,5598,9.45,0.67,0.84,-212,66,166542,193183,220643937,22207,0.67,0.68,0.83,0.85,234
2022-05-29,21_2022,0,14826,17388877,5494,10.44,0.63,0.83,-104,27,166569,142066,220786003,4199,0.62,0.64,0.83,0.84,234
2022-05-30,22_2022,0,7537,17396723,5536,9.4,0.55,0.83,42,62,166631,80177,220866180,23645,0.54,0.55,0.82,0.84,85
2022-05-31,22_2022,0,24267,17421410,5369,10.03,0.46,0.83,-167,66,166697,242060,221108240,27677,0.46,0.47,0.82,0.84,85
2022-06-01,22_2022,0,18391,17440232,5101,9.57,0.37,0.83,-268,59,166756,192108,221300348,20900,0.36,0.37,0.82,0.84,85
